Name,Pos,Birthdate,Birth City,Country,GP,G,A,P,PIM
"Aalto, Antti",F,03/04/1975,Lappeenranta,Finland,151,11,17,28,52
"Abbott, George",G,08/03/1911,"Sydenham, Ontario",Canada,1,0,0,0,0
"Abbott, Reg",F,02/04/1930,"Winnipeg, Manitoba",Canada,3,0,0,0,0
"Abbott, Spencer",F,04/30/1988,"Hamilton, Ontario",Canada,2,0,0,0,0
"Abdelkader, Justin",F,02/25/1987,"Muskegon, Michigan",United States,739,106,146,252,608
"Abel, Clarence",D,05/28/1900,"Sault Ste. Marie, Michigan",United States,333,20,18,38,365
"Abel, Gerry",F,12/25/1944,"Detroit, Michigan",United States,1,0,0,0,0
"Abel, Sid",F,02/22/1918,"Melville, Saskatchewan",Canada,612,188,284,472,376
"Åberg, Pontus",F,09/23/1993,Stockholm,Sweden,132,17,27,44,34
"Abgrall, Dennis",F,04/24/1953,"Moosomin, Saskatchewan",Canada,13,0,2,2,4
"Abid, Ramzi",F,03/24/1980,"Montréal, Quebec",Canada,68,14,16,30,78
"Abrahamsson, Thommy",D,04/12/1947,Umeå,Sweden,32,6,11,17,16
"Abramov, Vitaly",F,05/08/1998,Chelyabinsk,Russia,5,1,0,1,2
"Abruzzese, Nick",F,06/04/1999,"Slate Hill, New York",United States,9,1,0,1,2
"Acciari, Noel",F,12/01/1991,"Johnston, Rhode Island",United States,307,45,32,77,121
"Achtymichuk, Gene",F,09/07/1932,"Lamont, Alberta",Canada,32,3,5,8,2
"Acomb, Doug",F,05/15/1949,"Toronto, Ontario",Canada,2,0,1,1,0
"Acton, Keith",F,04/15/1958,"Stouffville, Ontario",Canada,1023,226,358,584,1172
"Acton, Will",F,07/16/1987,"Stouffville, Ontario",Canada,33,3,2,5,26
"Adam, Doug",F,09/07/1923,"Toronto, Ontario",Canada,4,0,1,1,0
"Adam, Luke",F,06/18/1990,"St. John's, Newfoundland and Labrador",Canada,90,15,11,26,36
"Adam, Russ",F,05/05/1961,"Windsor, Ontario",Canada,8,1,2,3,11
"Adams, Bryan",F,03/20/1977,"Fort St. James, British Columbia",Canada,11,0,1,1,2
"Adams, Craig",F,04/26/1977,Seria,Brunei,951,55,105,160,683
"Adams, Greg",F,08/15/1963,"Nelson, British Columbia",Canada,1056,355,388,743,321
"Adams, Greg",F,05/31/1960,"Duncan, British Columbia",Canada,544,84,143,227,1173
"Adams, Jack",F,05/05/1920,"Calgary, Alberta",Canada,42,6,12,18,9
"Adams, Jack",F,06/14/1895,"Thunder Bay, Ontario",Canada,173,81,44,125,384
"Adams, John",G,07/27/1946,"Thunder Bay, Ontario",Canada,22,0,0,0,2
"Adams, Kevyn",F,10/08/1974,"Washington, District of Columbia",United States,540,59,77,136,317
"Adams, Stewart",F,10/16/1904,"Calgary, Alberta",Canada,93,9,26,35,70
"Addison, Calen",D,04/11/2000,"Brandon, Manitoba",Canada,18,2,2,4,2
"Adduono, Rick",F,01/25/1955,"Thunder Bay, Ontario",Canada,4,0,0,0,2
"Aebischer, David",G,02/07/1978,Fribourg,Switzerland,214,0,5,5,30
"Afanasenkov, Dmitry",F,05/12/1980,Arkhangelsk,Russia,227,27,27,54,52
"Affleck, Bruce",D,05/05/1954,"Salmon Arm, British Columbia",Canada,280,14,66,80,86
"Afinogenov, Maxim",F,09/04/1979,Moscow,Russia,651,158,237,395,486
"Agnew, Jim",D,03/21/1966,"Deloraine, Manitoba",Canada,81,0,1,1,257
"Agostino, Kenny",F,04/30/1992,"Morristown, New Jersey",United States,86,8,22,30,40
"Agozzino, Andrew",F,01/03/1991,"Kleinburg, Ontario",Canada,47,2,7,9,4
"Ahcan, Jack",D,05/18/1997,"Savage, Minnesota",United States,9,1,0,1,0
"Ahern, Fred",F,02/12/1952,"Boston, Massachusetts",United States,146,31,30,61,130
"Ahlin, Rudy",F,12/13/1908,"Eveleth, Minnesota",United States,1,0,0,0,0
"Aho, Sebastian",D,02/17/1996,Umeå,Sweden,61,4,14,18,18
"Aho, Sebastian",F,07/26/1997,Rauma,Finland,445,182,219,401,172
"Ahola, Peter",D,05/14/1968,Espoo,Finland,123,10,17,27,137
"Ahrens, Chris",D,07/31/1952,"San Bernardino, California",United States,52,0,3,3,84
"Aiken, Don",G,01/01/1932,"Arlington, Massachusetts",United States,1,0,0,0,0
"Ailsby, Lloyd",D,05/11/1917,"Lac Pelletier, Saskatchewan",Canada,3,0,0,0,2
"Aitken, Brad",F,10/30/1967,"Scarborough, Ontario",Canada,14,1,3,4,25
"Aitken, Johnathan",D,05/24/1978,"Edmonton, Alberta",Canada,44,0,1,1,70
"Aitkenhead, Andy",G,03/06/1904,"Glasgow, Scotland",United Kingdom,106,0,0,0,0
"Aittokallio, Sami",G,08/06/1992,Tampere,Finland,2,0,0,0,0
"Aivazoff, Micah",F,05/04/1969,"Powell River, British Columbia",Canada,92,4,6,10,46
"Akeson, Jason",F,06/03/1990,"Orleans, Ontario",Canada,15,1,1,2,8
"Alatalo, Mika",F,06/11/1971,Oulu,Finland,152,17,29,46,58
"Albelin, Tommy",D,05/21/1964,Stockholm,Sweden,952,44,211,255,417
"Albert, John",F,01/19/1989,"Cleveland, Ohio",United States,9,1,0,1,0
"Alberts, Andrew",D,06/30/1981,"Minneapolis, Minnesota",United States,459,8,47,55,492
"Albright, Clint",F,02/28/1926,"Winnipeg, Manitoba",Canada,59,14,5,19,19
"Aldcorn, Gary",F,03/07/1935,"Shaunavon, Saskatchewan",Canada,226,41,56,97,78
"Aldridge, Keith",F,07/20/1973,"Detroit, Michigan",United States,4,0,0,0,0
"Alexander, Claire",D,06/16/1945,"Collingwood, Ontario",Canada,155,18,47,65,36
"Alexandre, Art",F,03/02/1909,"Saint-Jean-sur-Richelieu, Quebec",Canada,11,0,2,2,0
"Alexeyev, Alexander",D,11/15/1999,Saint Petersburg,Russia,1,0,0,0,2
"Alexeyev, Nikita",F,12/27/1981,Murmansk,Russia,159,20,17,37,28
"Alfredsson, Daniel",F,12/11/1972,Göteborg,Sweden,1246,444,713,1157,510
"Aliu, Akim",F,04/24/1989,Okene,Nigeria,7,2,1,3,26
"Allan, Jeff",D,05/17/1957,"Hull, Quebec",Canada,4,0,0,0,2
"Allard, Frederic",D,12/27/1997,"Québec City, Quebec",Canada,1,0,0,0,0
"Allen, Bobby",D,11/14/1978,"Weymouth, Massachusetts",United States,51,0,3,3,12
"Allen, Bryan",D,08/21/1980,"Kingston, Ontario",Canada,721,29,107,136,839
"Allen, Chris",D,05/08/1978,"Chatham, Ontario",Canada,2,0,0,0,2
"Allen, Conor",D,01/31/1990,"Chicago, Illinois",United States,7,0,0,0,4
"Allen, George",D,07/27/1914,"Bayfield, New Brunswick",Canada,340,82,115,197,181
"Allen, Jake",G,08/07/1990,"Fredericton, New Brunswick",Canada,353,0,4,4,10
"Allen, Keith",D,08/21/1923,"Saskatoon, Saskatchewan",Canada,28,0,4,4,6
"Allen, Peter",D,03/06/1970,"Calgary, Alberta",Canada,8,0,0,0,8
"Allen, Vivan",F,09/09/1916,"Bayfield, New Brunswick",Canada,11,0,1,1,0
"Alley, Steve",F,12/29/1953,"Anoka, Minnesota",United States,15,3,3,6,11
"Allison, David",D,04/14/1959,"Fort Frances, Ontario",Canada,3,0,0,0,12
"Allison, Jamie",D,05/13/1975,"Lindsay, Ontario",Canada,372,7,23,30,639
"Allison, Jason",F,05/29/1975,"North York, Ontario",Canada,552,154,331,485,441
"Allison, Mike",F,03/28/1961,"Fort Frances, Ontario",Canada,499,102,166,268,630
"Allison, Ray",F,03/04/1959,"Cranbrook, British Columbia",Canada,238,64,93,157,223
"Allison, Wade",F,10/14/1997,"Roland, Manitoba",Canada,15,4,3,7,4
"Allum, Bill",D,10/09/1916,"Winnipeg, Manitoba",Canada,1,0,1,1,0
"Almas, Ralph 'Red'",G,04/26/1924,"Saskatoon, Saskatchewan",Canada,3,0,0,0,0
"Almond, Cody",F,07/24/1989,"Calgary, Alberta",Canada,25,2,0,2,26
"Almquist, Adam",D,02/27/1991,Jönköping,Sweden,2,1,0,1,0
"Alnefelt, Hugo",G,06/04/2001,Danderyd,Sweden,1,0,0,0,0
"Alsing, Olle",D,05/01/1996,Uppsala,Sweden,4,0,0,0,0
"Alt, Mark",D,10/18/1991,"Kansas City, Missouri",United States,20,0,0,0,4
"Alves, Jorge",G,01/30/1979,"Stoughton, Massachusetts",United States,1,0,0,0,0
"Alzner, Karl",D,09/24/1988,"Burnaby, British Columbia",Canada,686,20,110,130,219
"Amadio, Dave",D,04/23/1939,"Glace Bay, Nova Scotia",Canada,126,5,11,16,163
"Amadio, Mike",F,05/13/1996,"Sault Ste. Marie, Ontario",Canada,229,27,31,58,43
"Ambroziak, Peter",F,09/15/1971,"Kanata, Ontario",Canada,12,0,1,1,0
"Amodeo, Mike",D,06/22/1952,"Toronto, Ontario",Canada,19,0,0,0,2
"Amonte, Tony",F,08/02/1970,"Hingham, Massachusetts",United States,1174,416,484,900,752
"Andersen, Frederik",G,10/02/1989,Herning,Denmark,445,0,13,13,26
"Anderson, Craig",G,05/21/1981,"Park Ridge, Illinois",United States,683,0,19,19,54
"Anderson, Dale",D,03/05/1932,"Regina, Saskatchewan",Canada,13,0,0,0,6
"Anderson, Earl",F,02/24/1951,"Roseau, Minnesota",United States,109,19,19,38,22
"Anderson, Glenn",F,10/02/1960,"Vancouver, British Columbia",Canada,1129,498,601,1099,1120
"Anderson, Jim",F,12/01/1930,"Pembroke, Ontario",Canada,7,1,2,3,2
"Anderson, Joey",F,06/19/1998,"Roseville, Minnesota",United States,58,8,5,13,10
"Anderson, John",F,03/28/1957,"Toronto, Ontario",Canada,814,282,349,631,261
"Anderson, Josh",F,05/07/1994,"Burlington, Ontario",Canada,388,101,70,171,315
"Anderson, Lorne",G,07/26/1931,"Renfrew, Ontario",Canada,3,0,0,0,0
"Anderson, Matt",F,10/31/1982,"West Islip, New York",United States,2,0,1,1,0
"Anderson, Michael",D,05/25/1999,"Fridley, Minnesota",United States,117,4,16,20,38
"Anderson, Murray",D,08/28/1949,"The Pas, Manitoba",Canada,40,0,1,1,68
"Anderson, Perry",F,10/14/1961,"Barrie, Ontario",Canada,400,50,59,109,1051
"Anderson, Ron",F,01/21/1950,"Moncton, New Brunswick",Canada,28,9,7,16,8
"Anderson, Ron",F,07/29/1945,"Red Deer, Alberta",Canada,251,28,30,58,146
"Anderson, Russ",D,02/12/1955,"Minneapolis, Minnesota",United States,519,22,99,121,1086
"Anderson, Shawn",D,02/07/1968,"Montréal, Quebec",Canada,255,11,51,62,117
"Anderson, Tommy",F,07/09/1910,"Edinburgh, Scotland",United Kingdom,316,62,127,189,194
"Anderson-Dolan, Jaret",F,09/12/1999,"Calgary, Alberta",Canada,50,7,5,12,10
"Andersson, Erik",F,08/19/1971,Stockholm,Sweden,12,2,1,3,8
"Andersson, Joakim",F,02/05/1989,Munkedal,Sweden,205,15,21,36,48
"Andersson, Jonas",F,02/24/1981,Stockholm,Sweden,9,0,0,0,2
"Andersson, Kent-Erik",F,05/24/1951,Örebro,Sweden,456,72,103,175,78
"Andersson, Lias",F,10/13/1998,Smögen,Sweden,109,7,10,17,57
"Andersson, Mikael",F,05/10/1966,Malmö,Sweden,761,95,169,264,134
"Andersson, Niklas",F,05/20/1971,Kungälv,Sweden,164,29,53,82,85
"Andersson, Peter",D,03/02/1962,Stockholm,Sweden,172,10,41,51,81
"Andersson, Peter",D,08/29/1965,Örebro,Sweden,47,6,13,19,20
"Andersson, Rasmus",D,10/27/1996,Malmö,Sweden,298,16,96,112,146
"Andrea, Paul",F,07/31/1941,"North Sydney, Nova Scotia",Canada,150,31,49,80,10
"Andreoff, Andy",F,05/17/1991,"Pickering, Ontario",Canada,185,14,12,26,225
"Andrews, Lloyd",F,11/04/1894,"Tillsonburg, Ontario",Canada,54,8,5,13,12
"Andreychuk, Dave",F,09/29/1963,"Hamilton, Ontario",Canada,1639,640,698,1338,1121
"Andrighetto, Sven",F,03/21/1993,Sumiswald,Switzerland,216,31,52,83,42
"Andrijevski, Alexander",F,08/10/1968,Minsk,Belarus,1,0,0,0,0
"Andruff, Ron",F,07/10/1953,"Port Alberni, British Columbia",Canada,153,19,36,55,54
"Andrusak, Greg",D,11/14/1969,"Cranbrook, British Columbia",Canada,28,0,6,6,16
"Angelidis, Mike",F,06/27/1985,"Woodbridge, Ontario",Canada,14,2,0,2,22
"Angello, Anthony",F,03/06/1996,"Manlius, New York",United States,31,3,2,5,14
"Angelstad, Mel",F,10/31/1971,"Saskatoon, Saskatchewan",Canada,2,0,0,0,2
"Angotti, Lou",F,01/16/1938,"Toronto, Ontario",Canada,653,103,186,289,220
"Anholt, Darrel",D,11/23/1962,"Hardisty, Alberta",Canada,1,0,0,0,0
"Anisimov, Artem",F,05/24/1988,Yaroslavl,Russia,771,180,196,376,214
"Annunen, Justus",G,03/11/2000,Kempele,Finland,2,0,1,1,0
"Anslow, Hub",F,03/23/1926,"Pembroke, Ontario",Canada,2,0,0,0,0
"Antipin, Viktor",D,12/06/1992,Ust-Kamenogorsk,Kazakhstan,47,0,10,10,18
"Antonovich, Mike",F,10/18/1951,"Calumet, Minnesota",United States,87,10,15,25,37
"Antoski, Shawn",F,03/25/1970,"Brantford, Ontario",Canada,183,3,5,8,599
"Antropov, Nikolai",F,02/18/1980,Ust-Kamenogorsk,Kazakhstan,788,193,272,465,627
"Appleby, Ken",G,04/10/1995,"North Bay, Ontario",Canada,3,0,0,0,0
"Appleton, Mason",F,01/15/1996,"Green Bay, Wisconsin",United States,206,28,36,64,68
"Apps, Syl",F,01/18/1915,"Paris, Ontario",Canada,423,201,231,432,56
"Apps, Syl",F,08/01/1947,"Toronto, Ontario",Canada,727,183,423,606,311
"Arbour, Al",D,11/01/1932,"Sudbury, Ontario",Canada,626,12,58,70,611
"Arbour, Amos",F,01/26/1895,"Waubaushene, Ontario",Canada,114,52,17,69,78
"Arbour, Jack",F,03/07/1899,"Waubaushene, Ontario",Canada,47,5,1,6,58
"Arbour, John",D,09/28/1945,"Niagara Falls, Ontario",Canada,106,1,9,10,149
"Arbour, Ty",F,06/29/1896,"Waubaushene, Ontario",Canada,207,28,28,56,110
"Archambault, Michel",F,09/27/1950,"Saint-Hyacinthe, Quebec",Canada,3,0,0,0,0
"Archibald, Darren",F,02/09/1990,"Newmarket, Ontario",Canada,55,6,8,14,26
"Archibald, Dave",F,04/14/1969,"Chilliwack, British Columbia",Canada,323,57,67,124,139
"Archibald, Jim",F,06/06/1961,"Craik, Saskatchewan",Canada,16,1,2,3,45
"Archibald, Josh",F,10/06/1992,"Regina, Saskatchewan",Canada,243,39,32,71,100
"Arcobello, Mark",F,08/12/1988,"Milford, Connecticut",United States,139,24,29,53,28
"Areshenkoff, Ron",F,06/13/1957,"Grand Forks, British Columbia",Canada,4,0,0,0,0
"Arkhipov, Denis",F,05/19/1979,Kazan,Russia,352,56,82,138,128
"Armia, Joel",F,05/31/1993,Pori,Finland,396,68,71,139,120
"Armstrong, Bill",F,06/25/1966,"London, Ontario",Canada,1,0,1,1,0
"Armstrong, Bob",D,04/07/1931,"Toronto, Ontario",Canada,541,13,86,99,671
"Armstrong, Chris",D,06/26/1975,"Regina, Saskatchewan",Canada,7,0,1,1,0
"Armstrong, Colby",F,11/23/1982,"Lloydminster, Saskatchewan",Canada,476,89,120,209,376
"Armstrong, Derek",F,04/23/1973,"Ottawa, Ontario",Canada,477,72,149,221,355
"Armstrong, George",F,07/06/1930,"Skead, Ontario",Canada,1188,296,417,713,726
"Armstrong, Murray",F,01/01/1916,"Manor, Saskatchewan",Canada,270,67,121,188,82
"Armstrong, Red",D,10/17/1938,"Owen Sound, Ontario",Canada,7,1,1,2,2
"Armstrong, Riley",F,11/08/1984,"Saskatoon, Saskatchewan",Canada,2,0,0,0,2
"Armstrong, Tim",F,05/12/1967,"Toronto, Ontario",Canada,11,1,0,1,6
"Arnason, Chuck",F,07/15/1951,"Ashern, Manitoba",Canada,401,109,90,199,122
"Arnason, Tyler",F,03/16/1979,"Oklahoma City, Oklahoma",United States,487,88,157,245,140
"Arniel, Jamie",F,11/16/1989,"Kingston, Ontario",Canada,1,0,0,0,0
"Arniel, Scott",F,09/17/1962,"Kingston, Ontario",Canada,730,149,189,338,599
"Arnold, Bill",F,05/13/1992,"Needham, Massachusetts",United States,1,0,0,0,0
"Arnott, Jason",F,10/11/1974,"Collingwood, Ontario",Canada,1244,417,521,938,1242
"Arsene, Dean",D,07/20/1980,"Murrayville, British Columbia",Canada,13,0,0,0,41
"Arthur, Fred",D,03/06/1961,"Toronto, Ontario",Canada,80,1,8,9,49
"Artyukhin, Evgeny",F,04/04/1983,Moscow,Russia,199,19,30,49,313
"Arundel, John",D,11/04/1927,"Winnipeg, Manitoba",Canada,3,0,0,0,9
"Arvedson, Magnus",F,11/25/1971,Karlstad,Sweden,434,100,125,225,241
"Arvidsson, Viktor",F,04/08/1993,Skellefteå,Sweden,451,147,141,288,194
"Asham, Arron",F,04/13/1978,"Portage la Prairie, Manitoba",Canada,789,94,114,208,1004
"Ashbee, Barry",D,07/28/1939,"Weston, Ontario",Canada,284,15,70,85,291
"Ashby, Don",F,03/08/1955,"Kamloops, British Columbia",Canada,188,40,56,96,40
"Ashton, Brent",F,05/18/1960,"Saskatoon, Saskatchewan",Canada,998,284,345,629,637
"Ashton, Carter",F,04/01/1991,"Winnipeg, Manitoba",Canada,54,0,3,3,32
"Ashworth, Frank",F,10/16/1927,"Moose Jaw, Saskatchewan",Canada,18,5,4,9,2
"Askey, Tom",G,10/04/1974,"Tonawanda, New York",United States,7,0,0,0,0
"Asmundson, Oscar",F,11/17/1908,"Red Deer, Alberta",Canada,111,11,23,34,30
"Asplund, Rasmus",F,12/03/1997,Filipstad,Sweden,137,16,25,41,16
"Astashenko, Kaspars",D,02/27/1975,Riga,Latvia,23,1,2,3,8
"Astley, Mark",D,03/30/1969,"Calgary, Alberta",Canada,75,4,19,23,92
"Aston-Reese, Zach",F,08/10/1994,"Staten Island, New York",United States,230,32,34,66,99
"Åström, Hardy",G,03/29/1951,Skellefteå,Sweden,83,0,1,1,8
"Atanas, Walt",F,12/22/1923,"Hamilton, Ontario",Canada,49,13,8,21,40
"Atcheynum, Blair",F,04/20/1969,"Estevan, Saskatchewan",Canada,196,27,33,60,36
"Athanasiou, Andreas",F,08/06/1994,"Woodbridge, Ontario",Canada,378,105,91,196,148
"Atkinson, Cam",F,06/05/1989,"Riverside, Connecticut",United States,700,236,216,452,156
"Atkinson, Steve",F,10/16/1948,"Toronto, Ontario",Canada,302,60,51,111,104
"Attard, Ronnie",D,03/20/1999,"White Lake, Michigan",United States,15,2,2,4,8
"Attwell, Bob",F,12/26/1959,"Spokane, Washington",United States,22,1,5,6,0
"Attwell, Ron",F,02/09/1935,"Humber Summit, Ontario",Canada,22,1,7,8,8
"Aube-Kubel, Nicolas",F,05/10/1996,"Sorel-Tracy, Quebec",Canada,169,21,29,50,110
"Aubin, Jean-Sebastien",G,07/19/1977,"Montréal, Quebec",Canada,218,0,3,3,10
"Aubin, Normand",F,07/26/1960,"Saint-Leonard, Quebec",Canada,69,18,13,31,30
"Aubin, Serge",F,02/15/1975,"Val-d'Or, Quebec",Canada,374,44,64,108,361
"Aubry, Pierre",F,04/15/1960,"Cap-de-la-Madeleine, Quebec",Canada,201,24,26,50,133
"Aubuchon, Oscar",F,01/01/1917,"Saint-Hyacinthe, Quebec",Canada,50,20,12,32,4
"Aucoin, Adrian",D,07/03/1973,"Ottawa, Ontario",Canada,1108,121,278,399,793
"Aucoin, Keith",F,11/06/1978,"Waltham, Massachusetts",United States,145,17,32,49,22
"Audet, Philippe",F,06/04/1977,"Ottawa, Ontario",Canada,4,0,0,0,0
"Audette, Donald",F,09/23/1969,"Laval, Quebec",Canada,735,260,249,509,584
"Auge, Les",D,05/16/1953,"St. Paul, Minnesota",United States,6,0,3,3,4
"Auger, Justin",F,05/14/1994,"Waterloo, Ontario",Canada,2,0,0,0,0
"Augusta, Patrik",F,11/13/1969,Jihlava,Czech Republic,4,0,0,0,0
"Auld, Alex",G,01/07/1981,"Cold Lake, Alberta",Canada,237,0,7,7,12
"Aulie, Keith",D,06/11/1989,"Rouleau, Saskatchewan",Canada,167,4,10,14,196
"Aulin, Jared",F,03/15/1982,"Calgary, Alberta",Canada,17,2,2,4,0
"Aurie, Larry",F,02/08/1905,"Sudbury, Ontario",Canada,489,147,128,275,283
"Austin, Brady",D,06/16/1993,"Bobcaygeon, Ontario",Canada,5,0,0,0,4
"Auvitu, Yohann",D,07/27/1989,Ivry-sur-Seine,France,58,5,8,13,10
"Avery, Sean",F,04/10/1980,"North York, Ontario",Canada,580,90,157,247,1533
"Awrey, Don",D,07/18/1943,"Kitchener, Ontario",Canada,979,31,158,189,1068
"Axelsson, Per-Johan",F,02/26/1975,Kungälv,Sweden,797,103,184,287,276
"Ayres, David",G,08/12/1977,"Whitby, Ontario",Canada,1,0,0,0,0
"Ayres, Vernon",D,04/27/1909,"Toronto, Ontario",Canada,211,6,11,17,332
"Babando, Pete",F,05/10/1925,"Braeburn, Pennsylvania",United States,351,86,73,159,194
"Babchuk, Anton",D,05/06/1984,Kiev,Ukraine,289,36,71,107,108
"Babcock, Bob",D,08/03/1968,"Agincourt, Ontario",Canada,2,0,0,0,2
"Babe, Warren",F,09/07/1968,"Medicine Hat, Alberta",Canada,21,2,5,7,23
"Babenko, Yuri",F,01/02/1978,Penza,Russia,3,0,0,0,0
"Babin, Mitch",F,11/01/1954,"Kapuskasing, Ontario",Canada,8,0,0,0,0
"Baby, John",D,05/18/1957,"Sudbury, Ontario",Canada,26,2,8,10,26
"Babych, Dave",D,05/23/1961,"Edmonton, Alberta",Canada,1195,142,581,723,970
"Babych, Wayne",F,06/06/1958,"Edmonton, Alberta",Canada,519,192,246,438,500
"Baca, Jergus",D,01/04/1965,Liptovsky Mikulas,Slovakia,10,0,2,2,14
"Bacashihua, Jason",G,09/20/1982,"Garden City, Michigan",United States,38,0,1,1,2
"Bach, Ryan",G,10/21/1973,"Sherwood Park, Alberta",Canada,3,0,0,0,0
"Bachman, Richard",G,07/25/1987,"Salt Lake City, Utah",United States,49,0,1,1,0
"Backes, David",F,05/01/1984,"Blaine, Minnesota",United States,965,248,313,561,1148
"Backlund, Johan",G,07/24/1981,Skellefteå,Sweden,1,0,0,0,0
"Backlund, Mikael",F,03/17/1989,Västerås,Sweden,826,166,270,436,395
"Bäckman, Christian",D,04/28/1980,Alingsås,Sweden,302,23,56,79,182
"Backman, Mike",F,01/02/1955,"Halifax, Nova Scotia",Canada,18,1,6,7,18
"Backor, Peter",D,04/29/1919,"Thunder Bay, Ontario",Canada,36,4,5,9,6
"Bäckström, Nicklas",F,11/23/1987,Gävle,Sweden,1058,264,747,1011,488
"Bäckström, Niklas",G,02/13/1978,Helsinki,Finland,413,0,5,5,22
"Backstrom, Ralph",F,09/18/1937,"Kirkland Lake, Ontario",Canada,1032,278,361,639,389
"Baddock, Brandon",F,03/29/1995,"Vermilion, Alberta",Canada,1,0,0,0,0
"Bagnall, Drew",D,10/26/1983,"Oakbank, Manitoba",Canada,2,0,0,0,4
"Bahl, Kevin",D,06/27/2000,"New Westminster, British Columbia",Canada,24,1,5,6,10
"Bailey, Bob",F,05/29/1931,"Kenora, Ontario",Canada,149,15,21,36,207
"Bailey, Casey",F,10/27/1991,"Anchorage, Alaska",United States,13,1,0,1,2
"Bailey, Garnet",F,06/13/1948,"Lloydminster, Saskatchewan",Canada,568,107,171,278,633
"Bailey, Irvine 'Ace'",F,07/03/1903,"Bracebridge, Ontario",Canada,316,111,81,192,488
"Bailey, Joshua",F,10/02/1989,"Oshawa, Ontario",Canada,993,176,379,555,239
"Bailey, Justin",F,07/01/1995,"Buffalo, New York",United States,82,5,4,9,18
"Bailey, Reid",D,05/28/1956,"Toronto, Ontario",Canada,40,1,3,4,105
"Bailey, Scott",G,05/02/1972,"Calgary, Alberta",Canada,19,0,0,0,0
"Baillargeon, Joel",F,10/06/1964,"Charlesbourg, Quebec",Canada,20,0,2,2,31
"Baird, Ken",D,02/01/1951,"Flin Flon, Manitoba",Canada,10,0,2,2,15
"Baker, Bill",D,11/29/1956,"Grand Rapids, Minnesota",United States,143,7,25,32,175
"Baker, Jamie",F,08/31/1966,"Ottawa, Ontario",Canada,404,71,79,150,271
"Baker, Steve",G,05/06/1957,"Boston, Massachusetts",United States,57,0,0,0,7
"Bakovic, Peter",F,01/31/1965,"Thunder Bay, Ontario",Canada,10,2,0,2,48
"Bala, Chris",F,09/24/1978,"Alexandria, Virginia",United States,6,0,1,1,0
"Balastik, Jaroslav",F,11/28/1979,Zlin,Czech Republic,74,13,11,24,30
"Balcers, Rudolfs",F,04/08/1997,Liepaja,Latvia,153,25,32,57,46
"Balderis, Helmut",F,07/31/1952,Riga,Latvia,26,3,6,9,2
"Baldwin, Doug",D,11/02/1922,"Winnipeg, Manitoba",Canada,24,0,1,1,8
"Balej, Jozef",F,02/22/1982,Myjava,Slovakia,18,1,5,6,4
"Bales, Mike",G,08/06/1971,"Prince Albert, Saskatchewan",Canada,23,0,0,0,2
"Balfour, Earl",F,01/04/1933,"Toronto, Ontario",Canada,288,30,22,52,78
"Balfour, Murray",F,08/24/1936,"Regina, Saskatchewan",Canada,306,67,90,157,389
"Balisy, Chase",F,02/02/1992,"Rancho Santa Margarita, California",United States,8,0,0,0,0
"Ball, Terry",D,11/29/1944,"Selkirk, Manitoba",Canada,74,7,19,26,26
"Ballard, Keith",D,11/26/1982,"Baudette, Minnesota",United States,604,38,137,175,612
"Balmochnykh, Maxim",F,03/07/1979,Lipetsk,Russia,6,0,1,1,2
"Balon, Dave",F,08/02/1938,"Wakaw, Saskatchewan",Canada,777,192,222,414,607
"Baltimore, Bryon",D,08/26/1952,"Whitehorse, Yukon",Canada,2,0,0,0,4
"Baluik, Stanley",F,10/05/1935,"Thunder Bay, Ontario",Canada,7,0,0,0,2
"Bancks, Carter",F,08/09/1989,"Marysville, British Columbia",Canada,2,0,0,0,0
"Bancroft, Steve",D,10/06/1970,"Toronto, Ontario",Canada,6,0,1,1,2
"Bandura, Jeff",D,02/04/1957,"White Rock, British Columbia",Canada,2,0,1,1,0
"Bång, Daniel",F,04/19/1987,Stockholm,Sweden,8,0,2,2,0
"Banham, Frank",F,04/14/1975,"Calahoo, Alberta",Canada,32,9,2,11,16
"Banks, Darren",F,03/18/1966,"Toronto, Ontario",Canada,20,2,2,4,73
"Bannerman, Murray",G,04/27/1957,"Fort Frances, Ontario",Canada,289,0,10,10,37
"Bannister, Drew",D,09/04/1974,"Belleville, Ontario",Canada,164,5,25,30,161
"Baptiste, Nicholas",F,08/04/1995,"Ottawa, Ontario",Canada,47,7,3,10,20
"Barabanov, Alexander",F,06/17/1994,Saint Petersburg,Russia,92,13,34,47,20
"Barahona, Ralph",F,11/16/1965,"Long Beach, California",United States,6,2,2,4,0
"Baranka, Ivan",D,05/19/1985,Ilava,Slovakia,1,0,1,1,0
"Barbashev, Ivan",F,12/14/1995,Moscow,Russia,351,68,81,149,92
"Barbe, Andy",F,07/27/1923,"Coniston, Ontario",Canada,1,0,0,0,2
"Barber, Bill",F,07/11/1952,"Callander, Ontario",Canada,903,420,463,883,623
"Barber, Don",F,12/02/1964,"Victoria, British Columbia",Canada,115,25,32,57,64
"Barber, Riley",F,02/07/1994,"Livonia, Michigan",United States,16,0,0,0,4
"Barberio, Mark",D,03/23/1990,"Montréal, Quebec",Canada,272,14,42,56,115
"Barch, Krys",F,03/26/1980,"Hamilton, Ontario",Canada,381,12,23,35,812
"Bardreau, Cole",F,07/22/1993,"Fairport, New York",United States,10,1,1,2,6
"Barilko, Bill",D,03/25/1927,"Timmins, Ontario",Canada,252,26,36,62,456
"Barinka, Michal",D,06/12/1984,Vyskov,Czech Republic,34,0,2,2,26
"Barker, Cam",D,04/04/1986,"Winnipeg, Manitoba",Canada,310,21,75,96,290
"Barkley, Doug",D,01/06/1937,"Lethbridge, Alberta",Canada,253,24,80,104,382
"Barkov, Aleksander",F,09/02/1995,Tampere,Finland,596,220,333,553,116
"Barlow, Bob",F,06/17/1935,"Hamilton, Ontario",Canada,77,16,17,33,10
"Barnaby, Matthew",F,05/04/1973,"Ottawa, Ontario",Canada,834,113,187,300,2562
"Barnes, Blair",F,09/21/1960,"Windsor, Ontario",Canada,1,0,0,0,0
"Barnes, Norm",D,08/24/1953,"Toronto, Ontario",Canada,156,6,38,44,178
"Barnes, Ryan",F,01/30/1980,"Dunnville, Ontario",Canada,2,0,0,0,0
"Barnes, Stu",F,12/25/1970,"Spruce Grove, Alberta",Canada,1136,261,336,597,438
"Barney, Scott",F,03/27/1979,"Oshawa, Ontario",Canada,27,5,6,11,4
"Baron, Marco",G,04/08/1959,"Montréal, Quebec",Canada,86,0,4,4,56
"Baron, Murray",D,06/01/1967,"Prince George, British Columbia",Canada,988,35,94,129,1309
"Baron, Normand",F,12/15/1957,"Verdun, Quebec",Canada,27,2,0,2,51
"Barr, Dave",F,11/30/1960,"Toronto, Ontario",Canada,614,128,204,332,520
"Barrasso, Tom",G,03/31/1965,"Boston, Massachusetts",United States,777,0,48,48,437
"Barrault, Doug",F,04/21/1970,"Golden, British Columbia",Canada,4,0,0,0,2
"Barre-Boulet, Alex",F,05/21/1997,"Montmagny, Quebec",Canada,31,6,3,9,4
"Barrett, Fred",D,01/26/1950,"Ottawa, Ontario",Canada,745,25,123,148,671
"Barrett, John",D,07/01/1958,"Ottawa, Ontario",Canada,488,20,77,97,604
"Barrie, Doug",D,10/02/1946,"Edmonton, Alberta",Canada,158,10,42,52,268
"Barrie, Len",F,06/04/1969,"Kimberley, British Columbia",Canada,184,19,45,64,290
"Barrie, Tyson",D,07/26/1991,"Victoria, British Columbia",Canada,683,95,340,435,207
"Barron, Justin",D,11/15/2001,"Halifax, Nova Scotia",Canada,7,1,1,2,0
"Barron, Morgan",F,12/02/1998,"Halifax, Nova Scotia",Canada,32,3,3,6,10
"Barry, Ed",F,10/12/1919,"Wellesley, Massachusetts",United States,19,1,3,4,2
"Barry, Marty",F,12/08/1905,"Québec City, Quebec",Canada,507,194,193,387,231
"Barry, Ray",F,10/04/1928,"Boston, Massachusetts",United States,18,1,2,3,6
"Bartecko, Lubos",F,07/14/1976,Kezmarok,Slovakia,257,46,65,111,107
"Bartel, Robin",D,05/16/1961,"Drake, Saskatchewan",Canada,41,0,1,1,14
"Bartkowski, Matt",D,06/04/1988,"Pittsburgh, Pennsylvania",United States,256,8,40,48,157
"Bartlett, Jim",F,05/27/1932,"Verdun, Quebec",Canada,191,34,23,57,273
"Bartley, Victor",D,02/17/1988,"Ottawa, Ontario",Canada,121,1,22,23,61
"Barton, Cliff",F,09/03/1907,"Sault Ste. Marie, Michigan",United States,85,10,11,21,25
"Bartos, Peter",F,09/05/1973,Martin,Slovakia,13,4,2,6,6
"Bartovic, Milan",F,04/09/1981,Trencín,Slovakia,50,3,14,17,26
"Bärtschi, Sven",F,10/05/1992,Langenthal,Switzerland,292,66,72,138,78
"Bartulis, Oskars",D,01/21/1987,Ogre,Latvia,66,1,8,9,32
"Barzal, Mathew",F,05/26/1997,"Vancouver, British Columbia",Canada,362,91,220,311,192
"Bashkirov, Andre",F,06/22/1970,Shelekhov,Russia,30,0,3,3,0
"Bass, Cody",F,01/07/1987,"Owen Sound, Ontario",Canada,75,2,3,5,107
"Bassen, Bob",F,05/06/1965,"Calgary, Alberta",Canada,765,88,144,232,1004
"Bassen, Hank",G,12/06/1932,"Calgary, Alberta",Canada,157,0,2,2,38
"Bast, Ryan",D,08/27/1975,"Spruce Grove, Alberta",Canada,2,0,1,1,0
"Bastian, Nathan",F,12/06/1997,"Kitchener, Ontario",Canada,120,18,13,31,96
"Bastien, Baz",G,08/29/1919,"Timmins, Ontario",Canada,5,0,0,0,0
"Bates, Shawn",F,04/03/1975,"Melrose, Massachusetts",United States,465,72,126,198,266
"Bathe, Frank",D,09/27/1954,"Oshawa, Ontario",Canada,224,3,28,31,542
"Batherson, Drake",F,04/27/1998,"Fort Wayne, Indiana",United States,145,40,57,97,59
"Bathgate, Andy",F,08/28/1932,"Winnipeg, Manitoba",Canada,1069,349,624,973,624
"Bathgate, Frank",F,02/14/1930,"Winnipeg, Manitoba",Canada,2,0,0,0,2
"Battaglia, Bates",F,12/13/1975,"Chicago, Illinois",United States,580,80,118,198,385
"Batters, Jeff",D,10/23/1970,"Victoria, British Columbia",Canada,16,0,0,0,28
"Batyrshin, Ruslan",D,02/19/1975,Moscow,Russia,2,0,0,0,6
"Bauer, Bobby",F,02/16/1915,"Waterloo, Ontario",Canada,327,123,136,259,38
"Bauman, Gary",G,07/21/1940,"Innisfail, Alberta",Canada,35,0,0,0,2
"Baumgartner, Ken",F,03/11/1966,"Flin Flon, Manitoba",Canada,696,13,41,54,2242
"Baumgartner, Mike",D,01/30/1949,"Roseau, Minnesota",United States,17,0,0,0,0
"Baumgartner, Nolan",D,03/23/1976,"Calgary, Alberta",Canada,143,7,40,47,69
"Baun, Bob",D,09/09/1936,"Lanigan, Saskatchewan",Canada,964,37,187,224,1489
"Baun, Kyle",F,05/04/1992,"Toronto, Ontario",Canada,5,0,0,0,0
"Bautin, Sergei",D,03/11/1967,Rahachow,Belarus,132,5,25,30,176
"Bawa, Robin",F,03/26/1966,"Duncan, British Columbia",Canada,61,6,1,7,60
"Baxter, Paul",D,10/28/1955,"Winnipeg, Manitoba",Canada,472,48,121,169,1564
"Bayda, Ryan",F,12/09/1980,"Saskatoon, Saskatchewan",Canada,179,16,24,40,94
"Bayreuther, Gavin",D,05/12/1994,"Canaan, New Hampshire",United States,71,3,11,14,39
"Beadle, Sandy",F,07/12/1960,"Regina, Saskatchewan",Canada,6,1,0,1,2
"Beagle, Jay",F,10/16/1985,"Calgary, Alberta",Canada,646,58,86,144,250
"Bean, Jake",D,06/09/1998,"Calgary, Alberta",Canada,111,8,29,37,38
"Bear, Ethan",D,06/26/1997,"Regina, Saskatchewan",Canada,190,13,34,47,77
"Beaton, Frank",F,04/28/1953,"Antigonish, Nova Scotia",Canada,25,1,1,2,43
"Beattie, Jack 'Red'",F,10/02/1907,"Ibstock, England",United Kingdom,329,62,85,147,134
"Beauchemin, Francois",D,06/04/1980,"Sorel-Tracy, Quebec",Canada,903,76,212,288,490
"Beaudin, Jean-Christophe",F,03/25/1997,"Saint-Bruno-de-Montarville, Quebec",Canada,22,0,1,1,7
"Beaudin, Nicolas",D,10/07/1999,"Châteauguay, Quebec",Canada,22,2,4,6,2
"Beaudin, Norm",F,11/28/1941,"Montmartre, Saskatchewan",Canada,25,1,2,3,4
"Beaudoin, Eric",F,05/03/1980,"Ottawa, Ontario",Canada,53,3,8,11,41
"Beaudoin, Serge",D,11/30/1952,"Montréal, Quebec",Canada,3,0,0,0,0
"Beaudoin, Yves",D,01/07/1965,"Pointe-aux-Trembles, Quebec",Canada,11,0,0,0,5
"Beaufait, Mark",F,05/13/1970,"Royal Oak, Michigan",United States,5,1,0,1,0
"Beaulieu, Nathan",D,12/05/1992,"Strathroy, Ontario",Canada,419,12,82,94,301
"Beaupre, Don",G,09/19/1961,"Waterloo, Ontario",Canada,666,0,8,8,268
"Beauregard, Stephane",G,01/10/1968,"Cowansville, Quebec",Canada,90,0,2,2,6
"Beauvillier, Anthony",F,06/08/1997,"Sorel-Tracy, Quebec",Canada,408,93,96,189,73
"Beck, Barry",D,06/03/1957,"Vancouver, British Columbia",Canada,615,104,251,355,1016
"Beck, Taylor",F,05/13/1991,"St. Catharines, Ontario",Canada,92,11,12,23,32
"Beckett, Bob",F,04/08/1936,"Unionville, Ontario",Canada,68,7,6,13,18
"Beckford-Tseu, Chris",G,06/22/1984,"Toronto, Ontario",Canada,1,0,0,0,0
"Beckman, Adam",F,05/10/2001,"Saskatoon, Saskatchewan",Canada,3,0,1,1,2
"Bedard, James",D,11/19/1927,"Admiral, Saskatchewan",Canada,22,1,1,2,8
"Bedard, Jim",G,11/14/1956,"Niagara Falls, Ontario",Canada,73,0,2,2,10
"Beddoes, Clayton",F,11/10/1970,"Bentley, Alberta",Canada,60,2,8,10,57
"Bednár, Jaroslav",F,11/09/1976,Prague,Czech Republic,102,10,25,35,30
"Bednarski, John",D,07/04/1952,"Thunder Bay, Ontario",Canada,100,2,18,20,114
"Beech, Kris",F,02/05/1981,"Salmon Arm, British Columbia",Canada,198,25,42,67,113
"Beers, Bob",D,05/20/1967,"Pittsburgh, Pennsylvania",United States,258,28,79,107,225
"Beers, Ed",F,10/12/1959,Zwaag,Netherlands,250,94,116,210,256
"Begin, Steve",F,06/14/1978,"Trois-Rivières, Quebec",Canada,524,56,52,108,561
"Behling, Clarence",D,03/16/1916,"Kitchener, Ontario",Canada,5,1,0,1,0
"Behrend, Marc",G,01/11/1961,"Madison, Wisconsin",United States,39,0,0,0,0
"Beisler, Frank",D,10/18/1913,"New Haven, Connecticut",United States,2,0,0,0,0
"Bekar, Derek",F,09/15/1975,"Burnaby, British Columbia",Canada,11,0,0,0,6
"Belak, Wade",D,07/03/1976,"Saskatoon, Saskatchewan",Canada,549,8,25,33,1263
"Belanger, Alain",F,01/18/1956,"Saint-Janvier, Quebec",Canada,9,0,1,1,6
"Belanger, Eric",F,12/16/1977,"Sherbrooke, Quebec",Canada,820,138,220,358,361
"Belanger, Francis",F,01/15/1978,"Bellefeuille, Quebec",Canada,10,0,0,0,29
"Belanger, Jesse",F,06/15/1969,"Saint-Georges, Quebec",Canada,246,59,76,135,56
"Belanger, Ken",F,05/14/1974,"Sault Ste. Marie, Ontario",Canada,248,11,12,23,695
"Belanger, Roger",F,12/01/1965,"St. Catharines, Ontario",Canada,44,3,5,8,32
"Belanger, Yves",G,09/30/1952,"Baie-Comeau, Quebec",Canada,78,0,5,5,4
"Beleskey, Matt",F,06/07/1988,"Windsor, Ontario",Canada,477,76,82,158,440
"Belfour, Ed",G,04/21/1965,"Carman, Manitoba",Canada,963,0,34,34,380
"Belhumeur, Michel",G,09/02/1949,"Sorel-Tracy, Quebec",Canada,65,0,4,4,12
"Belisle, Dan",F,05/09/1937,"Timmins, Ontario",Canada,4,2,0,2,0
"Beliveau, Jean",F,08/31/1931,"Trois-Rivières, Quebec",Canada,1125,507,712,1219,1033
"Bell, Billy",F,06/10/1891,"Lachine, Quebec",Canada,67,3,3,6,12
"Bell, Brendan",D,03/31/1983,"Ottawa, Ontario",Canada,102,7,21,28,51
"Bell, Bruce",D,02/15/1965,"Toronto, Ontario",Canada,209,12,64,76,113
"Bell, Gordon",G,03/13/1925,"Portage la Prairie, Manitoba",Canada,8,0,0,0,0
"Bell, Harry",D,10/31/1925,"Regina, Saskatchewan",Canada,1,0,1,1,0
"Bell, Joe",F,11/27/1923,"Portage la Prairie, Manitoba",Canada,62,8,9,17,18
"Bell, Mark",F,08/05/1980,"St. Pauls Station, Ontario",Canada,450,87,95,182,602
"Belland, Neil",D,04/03/1961,"Parry Sound, Ontario",Canada,109,13,32,45,54
"Belle, Shawn",D,01/03/1985,"Edmonton, Alberta",Canada,20,0,1,1,2
"Bellefeuille, Blake",F,12/27/1977,"Framingham, Massachusetts",United States,5,0,1,1,0
"Bellefeuille, Pete",F,10/19/1901,"Trois-Rivières, Quebec",Canada,92,26,6,32,56
"Bellemare, Pierre-Edouard",F,03/06/1985,Paris,France,587,56,62,118,142
"Bellemer, Andy",D,07/03/1903,"Penetanguishene, Ontario",Canada,15,0,0,0,0
"Bellemore, Brett",D,06/25/1988,"Windsor, Ontario",Canada,121,4,16,20,79
"Bellows, Brian",F,09/01/1964,"St. Catharines, Ontario",Canada,1188,485,537,1022,718
"Bellows, Kieffer",F,06/10/1998,"Edina, Minnesota",United States,67,11,14,25,25
"Belov, Anton",D,07/29/1986,Ryazan,Russia,57,1,6,7,34
"Belpedio, Louis",D,05/14/1996,"Skokie, Illinois",United States,4,0,2,2,0
"Belzile, Alex",F,08/31/1991,"Saint-Eloi, Quebec",Canada,13,0,1,1,4
"Bemström, Emil",F,06/01/1999,Nyköping,Sweden,117,19,17,36,12
"Bend, Linthwaite",F,12/20/1922,"Poplar Point, Manitoba",Canada,8,3,1,4,2
"Benda, Jan",F,04/28/1972,Reef,Belgium,9,0,3,3,6
"Benedict, Clint",G,09/26/1892,"Ottawa, Ontario",Canada,362,0,0,0,9
"Beniers, Matthew",F,11/05/2002,"Hingham, Massachusetts",United States,10,3,6,9,0
"Benn, Jamie",F,07/18/1989,"Victoria, British Columbia",Canada,948,329,440,769,734
"Benn, Jordie",D,07/26/1987,"Victoria, British Columbia",Canada,595,25,110,135,232
"Bennett, Adam",D,03/30/1971,"Georgetown, Ontario",Canada,69,3,8,11,69
"Bennett, Beau",F,11/27/1991,"Gardena, California",United States,200,24,40,64,52
"Bennett, Bill",F,05/31/1953,"Warwick, Rhode Island",United States,31,4,7,11,65
"Bennett, Curt",F,03/27/1948,"Regina, Saskatchewan",Canada,580,152,182,334,347
"Bennett, Frank",F,03/04/1922,"Toronto, Ontario",Canada,7,0,1,1,2
"Bennett, Harvey",G,07/23/1925,,,25,0,0,0,0
"Bennett, Harvey",F,08/09/1952,"Cranston, Rhode Island",United States,268,44,46,90,347
"Bennett, Max",F,11/04/1912,"Cobalt, Ontario",Canada,1,0,0,0,0
"Bennett, Rick",F,07/24/1967,"Springfield, Massachusetts",United States,15,1,1,2,13
"Bennett, Sam",F,06/20/1996,"Richmond Hill, Ontario",Canada,483,101,103,204,426
"Benning, Brian",D,06/10/1966,"Edmonton, Alberta",Canada,568,63,233,296,963
"Benning, Jim",D,04/29/1963,"Edmonton, Alberta",Canada,605,52,191,243,461
"Benning, Matthew",D,05/25/1994,"Edmonton, Alberta",Canada,366,16,60,76,195
"Benoit, Andre",D,01/06/1984,"St. Albert, Ontario",Canada,181,11,37,48,60
"Benoit, Joe",F,02/27/1916,"St. Albert, Alberta",Canada,185,75,69,144,94
"Benoit, Simon",D,09/19/1998,"Laval, Quebec",Canada,59,1,4,5,24
"Benson, Bill",F,07/29/1920,"Winnipeg, Manitoba",Canada,69,11,24,35,35
"Benson, Bobby",D,05/18/1894,"Winnipeg, Manitoba",Canada,8,0,2,2,4
"Benson, Tyler",F,03/15/1998,"Edmonton, Alberta",Canada,36,1,2,3,18
"Bentivoglio, Sean",F,10/16/1985,"Thorold, Ontario",Canada,1,0,0,0,2
"Bentley, Doug",F,09/03/1916,"Delisle, Saskatchewan",Canada,565,219,324,543,217
"Bentley, Max",F,03/01/1920,"Delisle, Saskatchewan",Canada,646,245,299,544,177
"Bentley, Reg",F,05/03/1914,"Delisle, Saskatchewan",Canada,11,1,2,3,2
"Benysek, Ladislav",D,03/24/1975,Olomouc,Czech Republic,161,3,12,15,74
"Beraldo, Paul",F,10/05/1967,"Hamilton, Ontario",Canada,10,0,0,0,4
"Beránek, Josef",F,10/25/1969,Litvinov,Czech Republic,531,118,144,262,398
"Berard, Bryan",D,03/05/1977,"Woonsocket, Rhode Island",United States,619,76,247,323,500
"Berehowsky, Drake",D,01/03/1972,"Toronto, Ontario",Canada,549,37,112,149,848
"Berenson, Red",F,12/08/1939,"Regina, Saskatchewan",Canada,987,261,397,658,303
"Berenzweig, Andrew",D,08/08/1977,"Arlington Heights, Illinois",United States,37,3,7,10,14
"Berezan, Perry",F,12/05/1964,"Edmonton, Alberta",Canada,378,61,75,136,277
"Berezin, Sergei",F,11/05/1971,Voskresensk,Russia,502,160,126,286,54
"Berg, Aki-Petteri",D,07/28/1977,Turku,Finland,606,15,70,85,374
"Berg, Bill",F,10/21/1967,"St. Catharines, Ontario",Canada,546,55,67,122,488
"Bergdinon, Fred",F,06/22/1906,"Parry Sound, Ontario",Canada,2,0,0,0,0
"Bergen, Todd",F,07/11/1963,"Prince Albert, Saskatchewan",Canada,14,11,5,16,4
"Bergenheim, Sean",F,02/08/1984,Helsinki,Finland,506,96,84,180,379
"Berger, Michael",D,06/02/1967,"Edmonton, Alberta",Canada,30,3,1,4,67
"Bergeron, Jean-Claude",G,10/14/1968,"Hauterive, Quebec",Canada,72,0,2,2,4
"Bergeron, Marc-Andre",D,10/13/1980,"Trois-Rivières, Quebec",Canada,490,82,153,235,214
"Bergeron, Michel",F,11/11/1954,"Chicoutimi, Quebec",Canada,229,80,58,138,165
"Bergeron, Patrice",F,07/24/1985,"L'Ancienne-Lorette, Quebec",Canada,1216,400,582,982,472
"Bergeron, Yves",F,01/11/1952,"Malartic, Quebec",Canada,3,0,0,0,0
"Bergevin, Marc",D,08/11/1965,"Montréal, Quebec",Canada,1191,36,145,181,1090
"Bergfors, Nicklas",F,03/07/1987,Södertälje,Sweden,173,35,48,83,20
"Bergkvist, Stefan",D,03/10/1975,Leksand,Sweden,7,0,0,0,9
"Bergland, Tim",F,01/11/1965,"Crookston, Minnesota",United States,182,17,26,43,75
"Bergloff, Bob",D,07/26/1958,"Dickinson, North Dakota",United States,2,0,0,0,5
"Berglund, Bo",F,04/06/1955,Själevad,Sweden,130,28,39,67,40
"Berglund, Christian",F,03/12/1980,Örebro,Sweden,86,11,16,27,42
"Berglund, Patrik",F,06/02/1988,Västerås,Sweden,717,170,156,326,248
"Bergman, Gary",D,10/07/1938,"Kenora, Ontario",Canada,838,68,299,367,1251
"Bergman, Thommie",D,12/10/1947,Munkfors,Sweden,246,21,44,65,243
"Bergmann, Lean",F,10/04/1998,Iserlohn,Germany,13,0,1,1,8
"Bergqvist, Jonas",F,09/26/1962,Hässleholm,Sweden,22,2,5,7,10
"Berkhoel, Adam",G,05/16/1981,"St. Paul, Minnesota",United States,9,0,0,0,0
"Berlinquette, Louis",F,05/26/1887,"Sainte-Angelique, Quebec",Canada,193,45,32,77,132
"Bernard-Docker, Jacob",D,06/30/2000,"Banff, Alberta",Canada,13,0,1,1,4
"Bernhardt, Tim",G,01/17/1958,"Sarnia, Ontario",Canada,67,0,3,3,4
"Bernier, Jonathan",G,08/07/1988,"Laval, Quebec",Canada,404,0,8,8,14
"Bernier, Serge",F,04/29/1947,"Padoue, Quebec",Canada,302,78,119,197,234
"Bernier, Steve",F,03/31/1985,"Vanier, Quebec",Canada,637,105,125,230,300
"Berra, Reto",G,01/03/1987,Bülach,Switzerland,76,0,1,1,4
"Berry, Bob",F,11/29/1943,"Montréal, Quebec",Canada,541,159,191,350,344
"Berry, Brad",D,04/01/1965,"Bashaw, Alberta",Canada,241,4,28,32,323
"Berry, Doug",F,06/03/1957,"New Westminster, British Columbia",Canada,121,10,33,43,24
"Berry, Fred",F,03/26/1956,"Edmonton, Alberta",Canada,3,0,0,0,0
"Berry, Ken",F,06/21/1960,"Burnaby, British Columbia",Canada,55,8,10,18,30
"Berry, Rick",D,11/04/1978,"Birtle, Manitoba",Canada,197,2,13,15,314
"Berthiaume, Daniel",G,01/26/1966,"Longueuil, Quebec",Canada,215,0,4,4,34
"Berti, Adam",F,07/01/1986,"Scarborough, Ontario",Canada,2,0,0,0,0
"Bertrand, Eric",F,04/16/1975,"Saint-Ephrem-de-Beauce, Quebec",Canada,15,0,0,0,4
"Bertschy, Christoph",F,04/05/1994,Le Mouret,Switzerland,9,0,1,1,8
"Bertuzzi, Todd",F,02/02/1975,"Sudbury, Ontario",Canada,1159,314,456,770,1478
"Bertuzzi, Tyler",F,02/24/1995,"Sudbury, Ontario",Canada,276,84,104,188,166
"Berube, Craig",F,12/17/1965,"Calahoo, Alberta",Canada,1054,61,98,159,3149
"Berube, Jean-Francois",G,07/13/1991,"Repentigny, Quebec",Canada,40,0,1,1,0
"Besler, Phil",F,12/09/1913,"Melville, Saskatchewan",Canada,30,1,4,5,18
"Bessone, Pete",D,01/13/1913,"New Bedford, Massachusetts",United States,6,0,1,1,6
"Bester, Allan",G,03/26/1964,"Hamilton, Ontario",Canada,219,0,8,8,32
"Bethel, John",F,01/15/1957,"Montréal, Quebec",Canada,17,0,2,2,4
"Betík, Karel",D,10/28/1978,Ostrava,Czech Republic,3,0,2,2,2
"Bets, Maxim",F,01/31/1974,Chelyabinsk,Russia,3,0,0,0,0
"Bettio, Sam",F,12/01/1928,"Copper Cliff, Ontario",Canada,44,9,12,21,34
"Betts, Blair",F,02/16/1980,"Edmonton, Alberta",Canada,477,41,37,78,118
"Beukeboom, Jeff",D,03/28/1965,"Ajax, Ontario",Canada,804,30,129,159,1890
"Beveridge, Bill",G,07/01/1909,"Ottawa, Ontario",Canada,295,0,0,0,0
"Beverley, Nick",D,04/21/1947,"Toronto, Ontario",Canada,502,18,94,112,156
"Bezina, Goran",D,03/21/1980,Split,Croatia,3,0,0,0,2
"Bialowas, Dwight",D,09/08/1952,"Regina, Saskatchewan",Canada,164,11,46,57,46
"Bialowas, Frank",F,09/25/1970,"Winnipeg, Manitoba",Canada,3,0,0,0,12
"Bianchin, Wayne",F,09/06/1953,"Nanaimo, British Columbia",Canada,276,68,41,109,137
"Bibeau, Antoine",G,05/01/1994,"Victoriaville, Quebec",Canada,4,0,0,0,0
"Bibeault, Paul",G,04/13/1919,"Montréal, Quebec",Canada,215,0,0,0,2
"Bicánek, Radim",D,01/18/1975,Uherske Hradiste,Czech Republic,122,1,11,12,62
"Bicek, Jiri",F,12/03/1978,Kosice,Slovakia,62,6,7,13,29
"Bickel, Stu",D,10/02/1986,"Chanhassen, Minnesota",United States,76,0,10,10,203
"Bickell, Bryan",F,03/09/1986,"Bowmanville, Ontario",Canada,395,66,70,136,192
"Bidner, Todd",F,07/05/1961,"Petrolia, Ontario",Canada,12,2,1,3,7
"Biega, Alex",D,04/04/1988,"Montréal, Quebec",Canada,243,4,38,42,122
"Biega, Dan",D,09/29/1991,"Montréal, Quebec",Canada,10,0,2,2,0
"Bieksa, Kevin",D,06/16/1981,"Grimsby, Ontario",Canada,808,63,215,278,1124
"Bierk, Zac",G,09/17/1976,"Peterborough, Ontario",Canada,47,0,1,1,6
"Biggs, Don",F,04/07/1965,"Mississauga, Ontario",Canada,12,2,0,2,8
"Bignell, Larry",D,01/07/1950,"Edmonton, Alberta",Canada,20,0,3,3,2
"Bigras, Chris",D,02/22/1995,"Orillia, Ontario",Canada,46,1,3,4,18
"Billington, Craig",G,09/11/1966,"London, Ontario",Canada,332,0,6,6,42
"Billins, Chad",D,05/26/1989,"Marysville, Michigan",United States,10,0,3,3,0
"Bilodeau, Gilles",F,07/31/1955,"Saint-Prime, Quebec",Canada,9,0,1,1,25
"Binette, Andre",G,12/02/1933,"Montréal, Quebec",Canada,1,0,0,0,0
"Binkley, Les",G,06/06/1934,"Owen Sound, Ontario",Canada,196,0,1,1,2
"Binnington, Jordan",G,07/11/1993,"Richmond Hill, Ontario",Canada,162,0,2,2,20
"Bionda, Jack",D,09/18/1933,"Huntsville, Ontario",Canada,93,3,9,12,111
"Biro, Brandon",F,03/11/1998,"Sherwood Park, Alberta",Canada,1,0,0,0,0
"Biron, Martin",G,08/15/1977,"Lac-Saint-Charles, Quebec",Canada,508,0,14,14,81
"Biron, Mathieu",D,04/29/1980,"Lac-Saint-Charles, Quebec",Canada,253,12,32,44,177
"Bisaillon, Sebastien",D,12/08/1986,"Mont-Laurier, Quebec",Canada,2,0,0,0,0
"Bischoff, Jake",D,07/25/1994,"Grand Rapids, Minnesota",United States,4,0,0,0,4
"Bishai, Mike",F,05/30/1979,"Edmonton, Alberta",Canada,14,0,2,2,19
"Bishop, Ben",G,11/21/1986,"Denver, Colorado",United States,413,0,12,12,34
"Bishop, Clark",F,03/29/1996,"St. John's, Newfoundland and Labrador",Canada,47,1,7,8,20
"Bissett, Tom",F,03/13/1966,"Seattle, Washington",United States,5,0,0,0,0
"Bissonnette, Paul",D,03/11/1985,"Welland, Ontario",Canada,202,7,15,22,340
"Bitetto, Anthony",D,07/15/1990,"Oceanside, New York",United States,197,3,28,31,142
"Bittner, Dick",G,01/12/1922,"New Haven, Connecticut",United States,1,0,0,0,0
"Bitz, Byron",F,07/21/1984,"Saskatoon, Saskatchewan",Canada,97,10,12,22,65
"Bjork, Anders",F,08/05/1996,"Mequon, Wisconsin",United States,211,24,29,53,42
"Björkqvist, Kasper",F,07/10/1997,Espoo,Finland,6,1,0,1,2
"Bjorkstrand, Oliver",F,04/10/1995,Herning,Denmark,382,111,123,234,74
"Björnfot, Tobias",D,04/06/2001,Upplands Väsby,Sweden,106,1,13,14,20
"Bjugstad, Nick",F,07/17/1992,"Minneapolis, Minnesota",United States,540,110,127,237,235
"Bjugstad, Scott",F,06/02/1961,"St. Paul, Minnesota",United States,317,76,68,144,144
"Black, James",F,08/15/1969,"Regina, Saskatchewan",Canada,352,58,57,115,84
"Black, Steve",F,03/31/1927,"Thunder Bay, Ontario",Canada,113,11,20,31,77
"Blackburn, Bob",D,02/01/1938,"Rouyn-Noranda, Quebec",Canada,135,8,12,20,105
"Blackburn, Dan",G,05/20/1983,"Montréal, Quebec",Canada,63,0,0,0,12
"Blackburn, Don",F,05/14/1938,"Kirkland Lake, Ontario",Canada,185,23,44,67,87
"Blacker, Jesse",D,04/19/1991,"Toronto, Ontario",Canada,1,0,0,0,0
"Blackwell, Colin",F,03/28/1993,"North Andover, Massachusetts",United States,138,25,27,52,41
"Blackwood, Mackenzie",G,12/09/1996,"Thunder Bay, Ontario",Canada,130,0,1,1,0
"Blade, Hank",F,04/28/1920,"Peterborough, Ontario",Canada,24,2,3,5,2
"Bladon, Tom",D,12/29/1952,"Edmonton, Alberta",Canada,610,73,197,270,392
"Blaine, Gary",D,04/19/1933,"St. Boniface, Manitoba",Canada,1,0,0,0,0
"Blair, Andy",F,02/27/1908,"Winnipeg, Manitoba",Canada,405,74,87,161,325
"Blair, Chuck",F,07/23/1928,"Edinburgh, Scotland",United Kingdom,1,0,0,0,0
"Blair, George",F,09/15/1929,"Timmins, Ontario",Canada,2,0,0,0,0
"Blais, Samuel",F,06/17/1996,"Montmagny, Quebec",Canada,133,17,22,39,61
"Blaisdell, Mike",F,01/18/1960,"Moose Jaw, Saskatchewan",Canada,343,70,84,154,166
"Blake, Bob",F,08/16/1914,"Ashland, Wisconsin",United States,12,0,0,0,0
"Blake, Jason",F,09/02/1973,"Moorhead, Minnesota",United States,871,213,273,486,455
"Blake, Mickey",F,10/31/1912,"Barriefield, Ontario",Canada,17,1,1,2,4
"Blake, Mike",G,04/06/1956,"Kitchener, Ontario",Canada,40,0,1,1,6
"Blake, Rob",D,12/10/1969,"Simcoe, Ontario",Canada,1270,240,537,777,1679
"Blake, Toe",F,08/21/1912,"Victoria Mines, Ontario",Canada,577,235,294,529,282
"Blanchard, Nicolas",F,05/31/1987,"Granby, Quebec",Canada,9,0,0,0,20
"Blandisi, Joseph",F,07/18/1994,"Markham, Ontario",Canada,101,10,21,31,78
"Blankenburg, Nick",D,05/12/1998,"Washington, Michigan",United States,7,1,2,3,4
"Blatný, Zdenek",F,01/14/1981,Brno,Czech Republic,25,3,0,3,8
"Blichfeld, Joachim",F,07/17/1998,Frederikshavn,Denmark,8,1,0,1,14
"Blidh, Anton",F,03/14/1995,Mölnlycke,Sweden,70,4,8,12,37
"Blight, Rick",F,10/17/1955,"Portage la Prairie, Manitoba",Canada,326,96,125,221,170
"Blinco, Russ",F,03/12/1908,"Grand-Mere, Quebec",Canada,265,59,66,125,24
"Bliznak, Mario",F,03/06/1987,Trencín,Slovakia,6,1,0,1,0
"Block, Ken",D,03/18/1944,"Steinbach, Manitoba",Canada,1,0,0,0,0
"Block, Matthew",D,05/16/1966,"Whittier, California",United States,35,0,5,5,97
"Bloemberg, Jeff",D,01/31/1968,"Listowel, Ontario",Canada,43,3,6,9,25
"Blomqvist, Timo",D,01/23/1961,Helsinki,Finland,243,4,53,57,293
"Blomsten, Arto",D,03/16/1965,Vaasa,Finland,25,0,4,4,8
"Bloom, Mike",F,04/12/1952,"Ottawa, Ontario",Canada,201,30,47,77,215
"Blouin, Sylvain",F,05/21/1974,"Montréal, Quebec",Canada,115,3,4,7,336
"Blue, John",G,02/19/1966,"Huntington Beach, California",United States,46,0,2,2,13
"Blueger, Teodors",F,08/15/1994,Riga,Latvia,205,31,51,82,66
"Blum, John",D,10/08/1959,"Detroit, Michigan",United States,250,7,34,41,610
"Blum, Jonathon",D,01/30/1989,"Long Beach, California",United States,110,7,17,24,22
"Blunden, Michael",F,12/15/1986,"Toronto, Ontario",Canada,127,7,6,13,145
"Bobrovsky, Sergei",G,09/20/1988,Novokuznetsk,Russia,592,0,10,10,24
"Bochenski, Brandon",F,04/04/1982,"Blaine, Minnesota",United States,156,28,40,68,54
"Bodak, Bob",F,05/28/1961,"Thunder Bay, Ontario",Canada,4,0,0,0,29
"Boddy, Gregg",D,03/19/1949,"Ponoka, Alberta",Canada,273,23,44,67,263
"Bodger, Doug",D,06/18/1966,"Chemainus, British Columbia",Canada,1071,106,422,528,1007
"Bodie, Troy",F,01/25/1985,"Portage la Prairie, Manitoba",Canada,159,9,12,21,172
"Bodnar, Gus",F,04/24/1923,"Thunder Bay, Ontario",Canada,667,142,255,397,207
"Bodnarchuk, Andrew",D,07/11/1988,"Drumheller, Alberta",Canada,42,0,4,4,16
"Boehm, Ron",F,08/14/1943,"Saskatoon, Saskatchewan",Canada,16,2,1,3,10
"Boesch, Garth",D,10/07/1920,"Milestone, Saskatchewan",Canada,197,9,28,37,203
"Boeser, Brock",F,02/25/1997,"Burnsville, Minnesota",United States,324,121,135,256,88
"Bogosian, Zach",D,07/15/1990,"Massena, New York",United States,737,56,152,208,673
"Boguniecki, Eric",F,05/06/1975,"New Haven, Connecticut",United States,178,34,42,76,105
"Boh, Rick",F,05/18/1964,"Kamloops, British Columbia",Canada,8,2,1,3,4
"Bohonos, Lonny",F,05/20/1973,"Winnipeg, Manitoba",Canada,83,19,16,35,22
"Boikov, Alexander",D,02/07/1975,Chelyabinsk,Russia,10,0,0,0,15
"Boileau, Marc",F,09/03/1932,"Pointe-Claire, Quebec",Canada,55,5,6,11,8
"Boileau, Patrick",D,02/22/1975,"Montréal, Quebec",Canada,48,5,11,16,26
"Boileau, Rene",F,05/18/1904,"Pointe-Claire, Quebec",Canada,7,0,0,0,0
"Boimistruck, Fred",D,01/14/1962,"Sudbury, Ontario",Canada,83,4,14,18,45
"Bois, Danny",F,06/01/1983,"Thunder Bay, Ontario",Canada,1,0,0,0,7
"Boisvert, Gilles",G,02/15/1933,"Trois-Rivières, Quebec",Canada,3,0,0,0,0
"Boisvert, Serge",F,06/01/1959,"Drummondville, Quebec",Canada,46,5,7,12,6
"Boivin, Claude",F,03/01/1970,"Sainte-Foy, Quebec",Canada,132,12,19,31,364
"Boivin, Leo",D,08/02/1931,"Prescott, Ontario",Canada,1150,72,250,322,1196
"Boland, Mike",F,12/16/1949,"Montréal, Quebec",Canada,2,0,0,0,0
"Boland, Mike",D,10/29/1954,"London, Ontario",Canada,23,1,2,3,29
"Boldirev, Ivan",F,08/15/1949,Zrenjanin,Serbia,1052,361,505,866,507
"Bolduc, Alexandre",F,06/26/1985,"Montréal, Quebec",Canada,65,2,3,5,44
"Bolduc, Danny",F,04/06/1953,"Waterville, Maine",United States,102,22,19,41,33
"Bolduc, Michel",D,03/13/1961,"Ange-Gardien, Quebec",Canada,10,0,0,0,6
"Boldy, Matthew",F,04/05/2001,"Millis, Massachusetts",United States,47,15,24,39,10
"Boll, Frank 'Buzz'",F,03/06/1911,"Fillmore, Saskatchewan",Canada,437,133,130,263,186
"Boll, Jared",F,05/13/1986,"Charlotte, North Carolina",United States,579,28,38,66,1298
"Bolland, David",F,06/05/1986,"Toronto, Ontario",Canada,433,85,123,208,299
"Bollig, Brandon",F,01/31/1987,"Saint Charles, Missouri",United States,241,10,13,23,392
"Bolonchuk, Larry",D,02/26/1952,"Winnipeg, Manitoba",Canada,74,3,9,12,97
"Bolton, Hugh",D,04/15/1929,"Toronto, Ontario",Canada,235,10,51,61,221
"Bombardir, Brad",D,05/05/1972,"Powell River, British Columbia",Canada,356,8,46,54,127
"Bonar, Dan",F,09/23/1956,"Brandon, Manitoba",Canada,170,25,39,64,208
"Bondra, Peter",F,02/07/1968,Lutsk,Ukraine,1081,503,389,892,761
"Bonin, Brian",F,11/28/1973,"St. Paul, Minnesota",United States,12,0,0,0,0
"Bonin, Marcel",F,09/12/1932,"Montréal, Quebec",Canada,454,97,175,272,334
"Bonino, Nick",F,04/20/1988,"Hartford, Connecticut",United States,761,148,186,334,215
"Bonk, Radek",F,01/09/1976,Krnov,Czech Republic,969,194,303,497,581
"Bonni, Ryan",D,02/18/1979,"Winnipeg, Manitoba",Canada,3,0,0,0,0
"Bonsignore, Jason",F,04/15/1976,"Rochester, New York",United States,79,3,13,16,34
"Bonvie, Dennis",F,07/23/1973,"Antigonish, Nova Scotia",Canada,92,1,2,3,311
"Boo, Jim",D,11/12/1954,"Rolla, Missouri",United States,6,0,0,0,22
"Boogaard, Derek",F,06/23/1982,"Saskatoon, Saskatchewan",Canada,277,3,13,16,589
"Boone, Buddy",F,09/11/1932,"Kirkland Lake, Ontario",Canada,34,5,3,8,28
"Booth, David",F,11/24/1984,"Detroit, Michigan",United States,530,124,112,236,216
"Boothman, George",D,09/25/1916,"Calgary, Alberta",Canada,58,17,19,36,18
"Bootland, Darryl",F,11/02/1981,"Toronto, Ontario",Canada,32,1,2,3,85
"Boqvist, Adam",D,08/15/2000,Falun,Sweden,128,17,34,51,32
"Boqvist, Jesper",F,10/30/1998,Falun,Sweden,119,18,16,34,20
"Bordeleau, Chris",F,09/23/1947,"Rouyn-Noranda, Quebec",Canada,205,38,65,103,82
"Bordeleau, J.P.",F,06/13/1949,"Rouyn-Noranda, Quebec",Canada,519,97,126,223,143
"Bordeleau, Patrick",F,03/23/1986,"Montréal, Quebec",Canada,129,8,8,16,185
"Bordeleau, Paulin",F,01/29/1953,"Rouyn-Noranda, Quebec",Canada,183,33,56,89,47
"Bordeleau, Sebastien",F,02/15/1975,"Vancouver, British Columbia",Canada,251,37,61,98,118
"Bordeleau, Thomas",F,01/03/2002,"Houston, Texas",United States,8,0,5,5,0
"Borer, Casey",D,07/28/1985,"Minneapolis, Minnesota",United States,16,1,2,3,9
"Borgen, William",D,12/19/1996,"Moorhead, Minnesota",United States,50,2,6,8,32
"Borgman, Andreas",D,06/18/1995,Stockholm,Sweden,55,3,10,13,32
"Borgström, Henrik",F,08/06/1997,Helsinki,Finland,110,13,13,26,28
"Borotsik, Jack",F,11/26/1949,"Brandon, Manitoba",Canada,1,0,0,0,0
"Borowiecki, Mark",D,07/12/1989,"Ottawa, Ontario",Canada,454,15,41,56,836
"Borsato, Luciano",F,01/07/1966,"Richmond Hill, Ontario",Canada,203,35,55,90,113
"Borschevsky, Nikolai",F,01/12/1965,Tomsk,Russia,162,49,73,122,44
"Bortuzzo, Robert",D,03/18/1989,"Thunder Bay, Ontario",Canada,490,18,51,69,455
"Boschman, Laurie",F,06/04/1960,"Major, Saskatchewan",Canada,1009,229,348,577,2263
"Bossy, Mike",F,01/22/1957,"Montréal, Quebec",Canada,752,573,553,1126,210
"Bostrom, Helge",D,01/09/1894,"Gimli, Manitoba",Canada,96,3,3,6,68
"Botell, Mark",D,08/27/1961,"Scarborough, Ontario",Canada,32,4,10,14,31
"Bothwell, Tim",D,05/06/1955,"Vancouver, British Columbia",Canada,501,28,93,121,382
"Botterill, Jason",F,05/19/1976,"Edmonton, Alberta",Canada,88,5,9,14,89
"Botting, Cam",F,03/10/1954,"Kingston, Ontario",Canada,2,0,1,1,0
"Boucha, Henry",F,06/01/1951,"Warroad, Minnesota",United States,247,53,49,102,157
"Bouchard, Dan",G,12/12/1950,"Val-d'Or, Quebec",Canada,656,0,28,28,255
"Bouchard, Dick",F,12/02/1934,"Letellier, Manitoba",Canada,1,0,0,0,0
"Bouchard, Edmond",F,05/24/1892,"Saint-Etienne-des-Gres, Quebec",Canada,223,19,24,43,133
"Bouchard, Emile",D,09/04/1919,"Montréal, Quebec",Canada,786,49,144,193,865
"Bouchard, Evan",D,10/20/1999,"Oakville, Ontario",Canada,102,15,34,49,32
"Bouchard, Joel",D,01/23/1974,"Montréal, Quebec",Canada,364,22,53,75,264
"Bouchard, Pierre",D,02/20/1948,"Longueuil, Quebec",Canada,595,24,82,106,433
"Bouchard, Pierre-Marc",F,04/27/1984,"Sherbrooke, Quebec",Canada,593,110,246,356,190
"Boucher, Billy",F,11/10/1899,"Ottawa, Ontario",Canada,213,93,35,128,419
"Boucher, Brian",G,01/02/1977,"Woonsocket, Rhode Island",United States,328,0,3,3,18
"Boucher, Clarence",D,11/01/1896,"North Bay, Ontario",Canada,47,2,3,5,137
"Boucher, Frank",F,10/07/1901,"Ottawa, Ontario",Canada,557,160,264,424,110
"Boucher, Georges",F,08/19/1896,"Ottawa, Ontario",Canada,450,118,87,205,845
"Boucher, Philippe",D,03/24/1973,"Saint-Apollinaire, Quebec",Canada,748,94,206,300,702
"Boucher, Reid",F,09/08/1993,"Lansing, Michigan",United States,133,20,22,42,18
"Boucher, Robert",F,02/14/1904,"Ottawa, Ontario",Canada,11,1,0,1,0
"Bouck, Tyler",F,01/13/1980,"Camrose, Alberta",Canada,91,4,8,12,93
"Boudreau, Bruce",F,01/09/1955,"Toronto, Ontario",Canada,141,28,42,70,46
"Boudrias, Andre",F,09/19/1943,"Montréal, Quebec",Canada,662,151,340,491,216
"Boughner, Barry",F,01/29/1948,"Delhi, Ontario",Canada,20,0,0,0,11
"Boughner, Bob",D,03/08/1971,"Windsor, Ontario",Canada,630,15,57,72,1382
"Bouillon, Francis",D,10/17/1975,"New York, New York",United States,776,32,117,149,536
"Boulerice, Jesse",F,08/10/1978,"Plattsburgh, New York",United States,172,8,2,10,333
"Boulton, Eric",F,08/17/1976,"Halifax, Nova Scotia",Canada,654,31,48,79,1421
"Bouma, Lance",F,03/25/1990,"Provost, Alberta",Canada,357,30,46,76,210
"Boumedienne, Josef",D,01/12/1978,Stockholm,Sweden,47,4,12,16,36
"Bourbonnais, Dan",F,03/06/1962,"Winnipeg, Manitoba",Canada,59,3,25,28,11
"Bourbonnais, Rick",F,04/20/1955,"Toronto, Ontario",Canada,71,9,15,24,29
"Bourcier, Conrad",F,05/28/1916,"Montréal, Quebec",Canada,6,0,0,0,0
"Bourcier, Jean",F,01/03/1911,"Montréal, Quebec",Canada,9,0,1,1,0
"Bourdon, Luc",D,02/16/1987,"Shippagan, New Brunswick",Canada,36,2,0,2,24
"Bourdon, Marc-Andre",D,09/17/1989,"Saint-Hyacinthe, Quebec",Canada,45,4,3,7,52
"Bourgeault, Leo",D,01/17/1903,"Sturgeon Falls, Ontario",Canada,307,25,20,45,336
"Bourgeois, Charles",D,11/19/1959,"Moncton, New Brunswick",Canada,290,16,54,70,788
"Bourne, Bob",F,06/21/1954,"Netherhill, Saskatchewan",Canada,964,258,324,582,605
"Bournival, Michael",F,05/31/1992,"Shawinigan, Quebec",Canada,113,12,10,22,24
"Bourque, Christopher",F,01/29/1986,"Boston, Massachusetts",United States,51,2,6,8,18
"Bourque, Claude",G,03/31/1915,"Oxford, Nova Scotia",Canada,62,0,0,0,0
"Bourque, Gabriel",F,09/23/1990,"Rimouski, Quebec",Canada,413,40,63,103,75
"Bourque, Phil",F,06/08/1962,"Chelmsford, Massachusetts",United States,477,88,111,199,516
"Bourque, Ray",D,12/28/1960,"Montréal, Quebec",Canada,1612,410,1169,1579,1141
"Bourque, Rene",F,12/10/1981,"Lac la Biche, Alberta",Canada,725,163,153,316,584
"Bourque, Ryan",F,01/03/1991,"Topsfield, Massachusetts",United States,1,0,0,0,0
"Boutette, Pat",F,03/01/1952,"Windsor, Ontario",Canada,756,171,282,453,1354
"Boutilier, Paul",D,05/03/1963,"Sydney, Nova Scotia",Canada,288,27,83,110,358
"Boutin, Rollie",G,11/06/1957,"Westlock, Alberta",Canada,22,0,1,1,6
"Bouvrette, Lionel",G,06/10/1914,"Hawkesbury, Ontario",Canada,1,0,0,0,0
"Bouwmeester, Jay",D,09/27/1983,"Edmonton, Alberta",Canada,1240,88,336,424,635
"Bow, Landon",G,08/24/1995,"St. Albert, Alberta",Canada,2,0,0,0,0
"Bowen, Jason",D,11/09/1973,"Port Alice, British Columbia",Canada,77,2,6,8,109
"Bower, Johnny",G,11/08/1924,"Prince Albert, Saskatchewan",Canada,552,0,3,3,36
"Bowey, Madison",D,04/22/1995,"Winnipeg, Manitoba",Canada,158,5,35,40,104
"Bowler, Bill",F,09/25/1974,"Toronto, Ontario",Canada,9,0,2,2,8
"Bowman, Drayson",F,03/08/1989,"Grand Rapids, Michigan",United States,179,15,18,33,53
"Bowman, Kirk",F,09/30/1952,"Leamington, Ontario",Canada,88,11,17,28,19
"Bowman, Scotty",D,06/20/1911,"Winnipeg, Manitoba",Canada,281,8,17,25,267
"Bownass, Jack",D,07/27/1930,"Winnipeg, Manitoba",Canada,80,3,7,10,58
"Bowness, Rick",F,01/25/1955,"Moncton, New Brunswick",Canada,173,18,37,55,191
"Boyce, Darryl",F,07/07/1984,"Summerside, Prince Edward Island",Canada,84,6,12,18,68
"Boychuk, Johnny",D,01/19/1984,"Edmonton, Alberta",Canada,725,54,152,206,331
"Boychuk, Zach",F,10/04/1989,"Airdrie, Alberta",Canada,127,12,18,30,16
"Boyd, Bill",F,05/15/1898,"Belleville, Ontario",Canada,142,15,7,22,74
"Boyd, Dustin",F,07/16/1986,"Winnipeg, Manitoba",Canada,220,32,31,63,41
"Boyd, Irvin",F,11/13/1908,"Ardmore, Pennsylvania",United States,94,10,10,20,29
"Boyd, Randy",D,01/23/1962,"Coniston, Ontario",Canada,257,20,67,87,328
"Boyd, Travis",F,09/14/1993,"Hopkins, Minnesota",United States,198,30,46,76,46
"Boyer, Wally",F,09/27/1937,"Cowan, Manitoba",Canada,365,54,105,159,161
"Boyer, Zac",F,10/25/1971,"Inuvik, Northwest Territories",Canada,3,0,0,0,0
"Boyes, Brad",F,04/17/1982,"Mississauga, Ontario",Canada,822,211,294,505,251
"Boyko, Darren",F,01/16/1964,"Winnipeg, Manitoba",Canada,1,0,0,0,0
"Boyle, Brian",F,12/18/1984,"Hingham, Massachusetts",United States,871,141,111,252,615
"Boyle, Dan",D,07/12/1976,"Ottawa, Ontario",Canada,1093,163,442,605,693
"Boyle, Kevin",G,05/30/1992,"Manalapan Township, New Jersey",United States,5,0,0,0,0
"Boynton, Nicholas",D,01/14/1979,"Nobleton, Ontario",Canada,605,34,110,144,862
"Bozak, Tyler",F,03/19/1986,"Regina, Saskatchewan",Canada,814,170,291,461,236
"Bozek, Steve",F,11/26/1960,"Kelowna, British Columbia",Canada,641,164,167,331,309
"Bozon, Philippe",F,11/30/1966,Chamonix,France,144,16,25,41,101
"Brackenborough, John",F,02/09/1897,"Parry Sound, Ontario",Canada,7,0,0,0,0
"Brackenbury, Curt",F,01/31/1952,"Kapuskasing, Ontario",Canada,141,9,17,26,226
"Bradley, Barton",F,07/29/1930,"Thunder Bay, Ontario",Canada,1,0,0,0,0
"Bradley, Brian",F,01/21/1965,"Kitchener, Ontario",Canada,651,182,321,503,528
"Bradley, Lyle",F,07/31/1943,"Lloydminster, Saskatchewan",Canada,6,1,0,1,2
"Bradley, Matt",F,06/13/1978,"Stittsville, Ontario",Canada,675,59,90,149,562
"Brady, Neil",F,04/12/1968,"Montréal, Quebec",Canada,89,9,22,31,95
"Bragnalo, Rick",F,12/01/1951,"Thunder Bay, Ontario",Canada,145,15,35,50,46
"Brandner, Christoph",F,07/05/1975,Bruck an der Mur,Austria,35,4,5,9,8
"Branigan, Andy",D,04/11/1922,"Winnipeg, Manitoba",Canada,27,1,2,3,31
"Brännström, Erik",D,09/02/1999,Eksjö,Sweden,116,2,29,31,71
"Brasar, Per-Olov",F,09/30/1950,Falun,Sweden,348,64,142,206,33
"Brashear, Donald",F,01/07/1972,"Bedford, Indiana",United States,1025,85,120,205,2634
"Brassard, Derick",F,09/22/1987,"Hull, Quebec",Canada,951,202,320,522,435
"Brathwaite, Fred",G,11/24/1972,"Ottawa, Ontario",Canada,254,0,3,3,12
"Bratt, Jesper",F,07/30/1998,Stockholm,Sweden,307,70,133,203,54
"Braun, Justin",D,02/10/1987,"Vadnais Heights, Minnesota",United States,791,34,163,197,298
"Brayshaw, Russ",F,01/17/1918,"Saskatoon, Saskatchewan",Canada,43,5,9,14,24
"Breault, Frank",F,05/11/1967,"Acton Vale, Quebec",Canada,27,2,4,6,42
"Breen, Chris",D,06/29/1989,"Uxbridge, Ontario",Canada,9,0,2,2,5
"Breitenbach, Ken",D,01/09/1955,"Welland, Ontario",Canada,68,1,13,14,49
"Bremberg, Fredrik",F,06/21/1973,Södertälje,Sweden,8,0,0,0,2
"Brendl, Pavel",F,03/23/1981,Opocno,Czech Republic,78,11,11,22,16
"Brennan, Dan",F,10/01/1962,"Dawson Creek, British Columbia",Canada,8,0,1,1,9
"Brennan, Doug",D,01/10/1905,"Peterborough, Ontario",Canada,123,9,7,16,147
"Brennan, Kip",F,08/27/1980,"Kingston, Ontario",Canada,61,1,1,2,222
"Brennan, Rich",D,11/26/1972,"Schenectady, New York",United States,50,2,6,8,33
"Brennan, T.J.",D,04/03/1989,"Willingboro, New Jersey",United States,53,5,8,13,29
"Brennan, Tom",F,01/22/1922,"Philadelphia, Pennsylvania",United States,12,2,2,4,2
"Brenneman, John",F,01/05/1943,"Fort Erie, Ontario",Canada,152,21,19,40,46
"Brent, Tim",F,03/10/1984,"Cambridge, Ontario",Canada,207,21,27,48,76
"Bretto, Joe",D,11/28/1912,"Hibbing, Minnesota",United States,3,0,0,0,4
"Brewer, Carl",D,10/21/1938,"Toronto, Ontario",Canada,604,25,198,223,1018
"Brewer, Eric",D,04/17/1979,"Vernon, British Columbia",Canada,1009,77,194,271,792
"Brickley, Andy",F,08/09/1961,"Melrose, Massachusetts",United States,385,82,140,222,81
"Brickley, Connor",F,02/25/1992,"Everett, Massachusetts",United States,81,6,15,21,42
"Brickley, Daniel",D,03/30/1995,"Sandy, Utah",United States,5,0,2,2,0
"Briden, Archie",F,07/16/1898,"Renfrew, Ontario",Canada,73,9,5,14,56
"Bridgman, Mel",F,04/28/1955,"Trenton, Ontario",Canada,977,252,449,701,1625
"Briere, Daniel",F,10/06/1977,"Gatineau, Quebec",Canada,973,307,389,696,744
"Briere, Michel",F,10/21/1949,"Malartic, Quebec",Canada,76,12,32,44,20
"Brigley, Travis",F,06/16/1977,"Coronation, Alberta",Canada,55,3,6,9,16
"Brimanis, Aris",D,03/14/1972,"Cleveland, Ohio",United States,113,2,12,14,57
"Brimsek, Frank",G,09/26/1915,"Eveleth, Minnesota",United States,514,0,0,0,6
"Brind'Amour, Rod",F,08/09/1970,"Ottawa, Ontario",Canada,1484,452,732,1184,1100
"Brindley, Doug",F,06/08/1949,"Walkerton, Ontario",Canada,3,0,0,0,0
"Brine, David",F,01/06/1985,"Truro, Nova Scotia",Canada,9,0,1,1,4
"Brink, Bobby",F,07/08/2001,"Excelsior, Minnesota",United States,10,0,4,4,0
"Brink, Milton",F,11/26/1910,"Hibbing, Minnesota",United States,5,0,0,0,0
"Brisebois, Guillaume",D,07/21/1997,"Longueuil, Quebec",Canada,10,0,0,0,0
"Brisebois, Patrice",D,01/27/1971,"Montréal, Quebec",Canada,1009,98,322,420,623
"Brisson, Gerry",F,09/03/1937,"St. Boniface, Manitoba",Canada,4,0,2,2,4
"Britz, Greg",F,01/03/1961,"Buffalo, New York",United States,8,0,0,0,4
"Broadbent, Punch",F,07/13/1892,"Ottawa, Ontario",Canada,303,120,52,172,576
"Broadhurst, Alex",F,03/07/1993,"New Lenox, Illinois",United States,2,0,0,0,2
"Broberg, Philip",D,06/25/2001,Örebro,Sweden,23,1,2,3,8
"Brochu, Martin",G,03/10/1973,"Anjou, Quebec",Canada,9,0,0,0,2
"Brochu, Stephane",D,08/15/1967,"Sherbrooke, Quebec",Canada,1,0,0,0,0
"Broda, Walter 'Turk'",G,05/15/1914,"Brandon, Manitoba",Canada,629,0,0,0,8
"Broden, Connie",F,04/06/1932,"Montréal, Quebec",Canada,6,2,1,3,2
"Broderick, Ken",G,02/16/1942,"Toronto, Ontario",Canada,27,0,1,1,2
"Broderick, Len",G,10/11/1938,"Toronto, Ontario",Canada,1,0,0,0,0
"Brodeur, Martin",G,05/06/1972,"Montréal, Quebec",Canada,1266,2,45,47,122
"Brodeur, Mike",G,03/30/1983,"Calgary, Alberta",Canada,7,0,0,0,0
"Brodeur, Richard",G,09/15/1952,"Longueuil, Quebec",Canada,385,0,8,8,26
"Brodie, T.J.",D,06/07/1990,"Chatham, Ontario",Canada,772,53,255,308,240
"Brodin, Jonas",D,07/12/1993,Karlstad,Sweden,681,44,155,199,198
"Brodziak, Kyle",F,05/25/1984,"St. Paul, Alberta",Canada,917,129,167,296,462
"Brodzinski, Jonny",F,06/19/1993,"Blaine, Minnesota",United States,84,8,7,15,24
"Broll, David",F,01/04/1993,"Mississauga, Ontario",Canada,5,0,1,1,5
"Bromé, Mathias",F,07/29/1994,Örby,Sweden,26,1,1,2,8
"Bromley, Gary",G,01/19/1950,"Edmonton, Alberta",Canada,136,0,6,6,12
"Brookbank, Sheldon",D,10/03/1980,"Lanigan, Saskatchewan",Canada,351,7,37,44,473
"Brookbank, Wade",F,09/29/1977,"Lanigan, Saskatchewan",Canada,127,6,3,9,345
"Brooke, Bob",F,12/18/1960,"Melrose, Massachusetts",United States,447,69,97,166,520
"Brooks, Adam",F,05/06/1996,"Winnipeg, Manitoba",Canada,43,6,5,11,2
"Brooks, Alex",D,08/21/1976,"Madison, Wisconsin",United States,19,0,1,1,4
"Brooks, Arthur",G,02/04/1889,"Guelph, Ontario",Canada,4,0,0,0,0
"Brooks, Gord",F,09/11/1950,"Cobourg, Ontario",Canada,70,7,18,25,37
"Brooks, Ross",G,10/17/1937,"Toronto, Ontario",Canada,54,0,1,1,2
"Brophey, Evan",F,12/03/1986,"Kitchener, Ontario",Canada,4,0,0,0,0
"Brophy, Bernie",F,08/09/1905,"Collingwood, Ontario",Canada,62,4,4,8,25
"Brophy, Frank",G,08/09/1900,"Québec City, Quebec",Canada,21,0,0,0,0
"Brossart, Willie",D,05/29/1949,"Allan, Saskatchewan",Canada,129,1,14,15,88
"Brossoit, Laurent",G,03/23/1993,"Surrey, British Columbia",Canada,106,0,1,1,0
"Broten, Aaron",F,11/14/1960,"Roseau, Minnesota",United States,748,186,329,515,441
"Broten, Neal",F,11/29/1959,"Roseau, Minnesota",United States,1099,289,634,923,569
"Broten, Paul",F,10/27/1965,"Roseau, Minnesota",United States,322,46,55,101,264
"Brouillette, Julien",D,12/05/1986,"Saint-Esprit, Quebec",Canada,11,1,1,2,0
"Brousseau, Paul",F,09/18/1973,"Pierrefonds, Quebec",Canada,26,1,3,4,29
"Brouwer, Troy",F,08/17/1985,"Vancouver, British Columbia",Canada,851,182,181,363,595
"Brown, Adam",F,02/04/1920,"Johnstone, Scotland",United Kingdom,392,104,114,218,378
"Brown, Andy",G,02/15/1944,"Hamilton, Ontario",Canada,62,0,1,1,64
"Brown, Arnie",D,01/28/1942,"Oshawa, Ontario",Canada,681,44,141,185,740
"Brown, Brad",D,12/27/1975,"Baie Verte, Newfoundland and Labrador",Canada,330,2,27,29,747
"Brown, Cam",F,05/15/1969,"Saskatoon, Saskatchewan",Canada,1,0,0,0,7
"Brown, Chris",F,02/03/1991,"Houston, Texas",United States,23,2,1,3,21
"Brown, Connie",F,01/11/1917,"Vankleek Hill, Ontario",Canada,73,15,24,39,12
"Brown, Connor",F,01/14/1994,"Toronto, Ontario",Canada,444,90,126,216,90
"Brown, Curtis",F,02/12/1976,"Unity, Saskatchewan",Canada,736,129,171,300,398
"Brown, Dave",F,10/12/1962,"Saskatoon, Saskatchewan",Canada,729,45,52,97,1789
"Brown, Doug",F,06/12/1964,"Southborough, Massachusetts",United States,854,160,214,374,210
"Brown, Dustin",F,11/04/1984,"Ithaca, New York",United States,1296,325,387,712,738
"Brown, Fred",F,09/15/1900,"Kingston, Ontario",Canada,15,1,0,1,0
"Brown, George",F,05/17/1912,"Winnipeg, Manitoba",Canada,79,6,22,28,34
"Brown, Gerry",F,07/07/1917,"Edmonton, Alberta",Canada,23,4,5,9,2
"Brown, Greg",D,03/07/1968,"Southborough, Massachusetts",United States,94,4,14,18,86
"Brown, Harold",F,09/14/1920,"Brandon, Manitoba",Canada,13,2,1,3,2
"Brown, J.T.",F,07/02/1990,"Burnsville, Minnesota",United States,365,23,49,72,221
"Brown, Jeff",D,04/30/1966,"Ottawa, Ontario",Canada,747,154,430,584,498
"Brown, Jim",D,03/01/1960,"Phoenix, Arizona",United States,3,0,1,1,5
"Brown, Josh",D,01/21/1994,"London, Ontario",Canada,171,4,13,17,134
"Brown, Keith",D,05/06/1960,"Corner Brook, Newfoundland and Labrador",Canada,876,68,274,342,916
"Brown, Ken",G,12/19/1948,"Thunder Bay, Ontario",Canada,1,0,0,0,0
"Brown, Kevin",F,05/11/1974,"Birmingham, England",United Kingdom,64,7,9,16,28
"Brown, Larry",D,04/14/1947,"Brandon, Manitoba",Canada,455,7,53,60,180
"Brown, Logan",F,03/05/1998,"Raleigh, North Carolina",United States,69,5,15,20,14
"Brown, Mike",F,06/24/1985,"Northbrook, Illinois",United States,407,19,17,36,778
"Brown, Mike",F,04/29/1979,"Surrey, British Columbia",Canada,34,1,2,3,130
"Brown, Patrick",F,05/29/1992,"Bloomfield Hills, Michigan",United States,77,6,6,12,21
"Brown, Rob",F,04/10/1968,"Kingston, Ontario",Canada,543,190,248,438,599
"Brown, Sean",D,11/05/1976,"Oshawa, Ontario",Canada,436,14,43,57,907
"Brown, Stan",F,05/09/1898,"North Bay, Ontario",Canada,50,8,3,11,18
"Browne, Cecil",F,02/13/1896,"St. James, Manitoba",Canada,13,2,0,2,4
"Brownschidle, Jack",D,10/02/1955,"Buffalo, New York",United States,494,39,162,201,151
"Brownschidle, Jeff",D,03/01/1959,"Buffalo, New York",United States,7,0,1,1,2
"Brubaker, Jeff",F,02/24/1958,"Frederick, Maryland",United States,178,16,9,25,512
"Bruce, David",F,10/07/1964,"Thunder Bay, Ontario",Canada,234,48,39,87,338
"Bruce, Gordon",F,05/09/1919,"Ottawa, Ontario",Canada,27,4,9,13,13
"Bruce, Morley",D,03/07/1894,"North Gower, Ontario",Canada,71,8,2,10,27
"Brule, Gilbert",F,01/01/1987,"Edmonton, Alberta",Canada,299,43,52,95,156
"Brule, Steve",F,01/15/1975,"Montréal, Quebec",Canada,2,0,0,0,0
"Brumwell, Murray",D,03/31/1960,"Calgary, Alberta",Canada,128,12,31,43,70
"Brunet, Benoit",F,08/24/1968,"Sainte-Anne-de-Bellevue, Quebec",Canada,539,101,161,262,229
"Bruneteau, Ed",F,08/01/1919,"St. Boniface, Manitoba",Canada,180,40,42,82,35
"Bruneteau, Mud",F,11/28/1914,"St. Boniface, Manitoba",Canada,410,141,139,280,80
"Brunetta, Mario",G,01/25/1967,"Québec City, Quebec",Canada,40,0,0,0,16
"Brunette, Andrew",F,08/24/1973,"Sudbury, Ontario",Canada,1110,268,465,733,314
"Brunner, Damien",F,03/09/1986,Oberlunkhofen,Switzerland,121,25,33,58,46
"Brunnström, Fabian",F,02/06/1985,Jonstorp,Sweden,104,19,22,41,22
"Brust, Barry",G,08/08/1983,"Swan River, Manitoba",Canada,11,0,0,0,0
"Brydge, Bill",D,10/22/1901,"Renfrew, Ontario",Canada,368,26,52,78,516
"Brydges, Paul",F,06/21/1965,"Guelph, Ontario",Canada,15,2,2,4,6
"Brydson, Glen",F,11/07/1910,"Swansea, Ontario",Canada,299,54,79,133,209
"Brydson, Gord",F,01/03/1907,"Toronto, Ontario",Canada,8,2,0,2,8
"Brylin, Sergei",F,01/13/1974,Moscow,Russia,765,129,179,308,273
"Bryson, Jacob",D,11/18/1997,"London, Ontario",Canada,111,2,17,19,24
"Bryzgalov, Ilya",G,06/22/1980,Togliatti,Russia,465,0,12,12,20
"Bubla, Jiri",D,01/27/1950,Usti nad Labem,Czech Republic,256,17,101,118,202
"Buchanan, Al",F,05/17/1927,"Winnipeg, Manitoba",Canada,4,0,1,1,2
"Buchanan, Jeff",D,05/23/1971,"Swift Current, Saskatchewan",Canada,6,0,0,0,6
"Buchanan, Mike",D,03/01/1932,"Sault Ste. Marie, Ontario",Canada,1,0,0,0,0
"Buchanan, Ralph",F,12/28/1922,"Montréal, Quebec",Canada,2,0,0,0,0
"Buchanan, Ron",F,11/15/1944,"Montréal, Quebec",Canada,5,0,0,0,0
"Buchberger, Kelly",F,12/02/1966,"Langenburg, Saskatchewan",Canada,1182,105,204,309,2297
"Buchnevich, Pavel",F,04/17/1995,Cherepovets,Russia,374,109,162,271,146
"Bucyk, Johnny",F,05/12/1935,"Edmonton, Alberta",Canada,1540,556,813,1369,493
"Bucyk, Randy",F,11/09/1962,"Edmonton, Alberta",Canada,19,4,2,6,8
"Budaj, Peter",G,09/18/1982,Banska Bystrica,Slovakia,368,0,11,11,20
"Buhr, Doug",F,06/29/1949,"Vancouver, British Columbia",Canada,6,0,2,2,4
"Bukovich, Tony",F,08/30/1917,"Painesdale, Michigan",United States,17,7,3,10,6
"Bulis, Jan",F,03/18/1978,Pardubice,Czech Republic,552,96,149,245,268
"Bullard, Mike",F,03/10/1961,"Ottawa, Ontario",Canada,727,329,345,674,705
"Buller, Hy",D,03/15/1926,"Montréal, Quebec",Canada,188,22,58,80,215
"Bulley, Ted",F,03/25/1955,"Windsor, Ontario",Canada,414,101,113,214,704
"Bullock, Bruce",G,05/09/1949,"Toronto, Ontario",Canada,16,0,0,0,2
"Bulmer, Brett",F,04/26/1992,"Prince George, British Columbia",Canada,17,0,3,3,15
"Bunnaman, Connor",F,04/16/1998,"Guelph, Ontario",Canada,54,1,2,3,8
"Bunting, Michael",F,09/17/1995,"Scarborough, Ontario",Canada,105,34,43,77,94
"Bunz, Tyler",G,02/11/1992,"Regina, Saskatchewan",Canada,1,0,0,0,0
"Burakovsky, Andre",F,02/09/1995,Klagenfurt,Austria,519,123,172,295,127
"Burakowsky, Robert",F,11/24/1966,Malmö,Sweden,23,2,3,5,6
"Burch, Billy",F,11/20/1900,"Yonkers, New York",United States,390,136,60,196,263
"Burchell, Fred",F,01/09/1931,"Montréal, Quebec",Canada,4,0,0,0,2
"Burdon, Glen",F,08/04/1954,"Regina, Saskatchewan",Canada,11,0,2,2,0
"Bure, Pavel",F,03/31/1971,Moscow,Russia,702,437,342,779,484
"Bure, Valeri",F,06/13/1974,Moscow,Russia,621,174,226,400,221
"Bureau, Marc",F,05/19/1966,"Trois-Rivières, Quebec",Canada,567,55,83,138,327
"Burega, Bill",D,03/13/1932,"Winnipeg, Manitoba",Canada,4,0,1,1,4
"Burgdoerfer, Erik",D,12/11/1988,"East Setauket, New York",United States,8,0,1,1,2
"Burish, Adam",F,01/06/1983,"Madison, Wisconsin",United States,378,27,33,60,554
"Burke, Eddie",F,06/03/1907,"Toronto, Ontario",Canada,106,29,20,49,55
"Burke, Marty",D,01/28/1905,"Toronto, Ontario",Canada,503,18,48,66,578
"Burke, Sean",G,01/29/1967,"Windsor, Ontario",Canada,820,0,28,28,310
"Burmister, Roy",F,08/12/1906,"Collingwood, Ontario",Canada,67,4,3,7,0
"Burmistrov, Alexander",F,10/21/1991,Kazan,Russia,348,37,64,101,139
"Burnett, Garrett",F,09/23/1975,"Coquitlam, British Columbia",Canada,39,1,2,3,184
"Burnett, Kelly",F,06/16/1926,"Lachine, Quebec",Canada,3,1,0,1,0
"Burns, Bobby",F,04/04/1905,"Gore Bay, Ontario",Canada,19,1,0,1,2
"Burns, Brent",D,03/09/1985,"Ajax, Ontario",Canada,1251,227,550,777,763
"Burns, Charlie",F,02/14/1936,"Detroit, Michigan",United States,749,106,198,304,256
"Burns, Gary",F,01/16/1955,"Cambridge, Massachusetts",United States,11,2,2,4,18
"Burns, Norm",F,02/20/1918,"Youngstown, Alberta",Canada,11,0,4,4,2
"Burns, Robin",F,08/27/1946,"Montréal, Quebec",Canada,190,31,38,69,139
"Burr, Shawn",F,07/01/1966,"Sarnia, Ontario",Canada,878,181,259,440,1069
"Burridge, Randy",F,01/07/1966,"Fort Erie, Ontario",Canada,706,199,251,450,458
"Burroughs, Kyle",D,07/12/1995,"Vancouver, British Columbia",Canada,47,1,5,6,44
"Burrows, Alexandre",F,04/11/1981,"Pincourt, Quebec",Canada,913,205,204,409,1134
"Burrows, Dave",D,01/11/1949,"Toronto, Ontario",Canada,724,29,135,164,373
"Burry, Bert",D,02/07/1906,"Toronto, Ontario",Canada,4,0,0,0,0
"Burt, Adam",D,01/15/1969,"Detroit, Michigan",United States,737,37,115,152,961
"Burton, Cummy",F,05/12/1936,"Sudbury, Ontario",Canada,42,0,2,2,19
"Burton, Nelson",F,11/06/1957,"Sydney, Nova Scotia",Canada,8,1,0,1,21
"Bush, Eddie",D,07/11/1918,"Collingwood, Ontario",Canada,26,4,6,10,60
"Buskas, Rod",D,01/07/1961,"Wetaskiwin, Alberta",Canada,556,19,63,82,1294
"Busniuk, Mike",D,12/13/1951,"Thunder Bay, Ontario",Canada,143,3,23,26,297
"Busniuk, Ron",F,08/13/1948,"Thunder Bay, Ontario",Canada,6,0,3,3,13
"Buswell, Walter",D,11/06/1907,"Montréal, Quebec",Canada,368,10,41,51,164
"Butcher, Garth",D,01/08/1963,"Regina, Saskatchewan",Canada,897,48,158,206,2302
"Butcher, Will",D,01/06/1995,"Sun Prairie, Wisconsin",United States,275,16,98,114,34
"Butenschön, Sven",D,03/22/1976,Itzehoe,Germany,140,2,12,14,86
"Butler, Bobby",F,04/26/1987,"Marlborough, Massachusetts",United States,130,20,29,49,28
"Butler, Chris",D,10/27/1986,"St. Louis, Missouri",United States,407,14,72,86,187
"Butler, Dick",F,06/02/1926,"Delisle, Saskatchewan",Canada,7,2,0,2,0
"Butler, Jerry",F,02/27/1951,"Sarnia, Ontario",Canada,641,99,120,219,515
"Butsayev, Vyacheslav",F,06/13/1970,Togliatti,Russia,132,17,26,43,133
"Butsayev, Yuri",F,10/11/1978,Togliatti,Russia,99,10,4,14,28
"Butters, Bill",D,01/10/1951,"St. Paul, Minnesota",United States,72,1,4,5,77
"Buttrey, Gordon",F,03/17/1926,"Regina, Saskatchewan",Canada,10,0,0,0,0
"Buynak, Gordon",D,03/19/1954,"Detroit, Michigan",United States,4,0,0,0,2
"Buzek, Petr",D,04/25/1977,Jihlava,Czech Republic,157,9,22,31,94
"Buzinski, Stephen",G,10/15/1917,"Dunblane, Saskatchewan",Canada,9,0,0,0,0
"Byakin, Ilya",D,02/02/1963,Yekaterinburg,Russia,57,8,25,33,44
"Byce, John",F,08/09/1967,"Madison, Wisconsin",United States,21,2,3,5,6
"Byers, Dane",F,02/21/1986,"Nipawin, Saskatchewan",Canada,14,1,0,1,60
"Byers, Gordie",D,03/11/1930,"Eganville, Ontario",Canada,1,0,1,1,0
"Byers, Jerry",F,03/29/1952,"Kentville, Nova Scotia",Canada,43,3,4,7,15
"Byers, Lyndon",F,02/29/1964,"Nipawin, Saskatchewan",Canada,279,28,43,71,1081
"Byers, Mike",F,09/11/1946,"Toronto, Ontario",Canada,166,42,34,76,39
"Byfield, Quinton",F,08/19/2002,"Newmarket, Ontario",Canada,46,5,6,11,22
"Byfuglien, Dustin",D,03/27/1985,"Minneapolis, Minnesota",United States,869,177,348,525,1094
"Bykov, Dmitri",D,05/05/1977,Izhevsk,Russia,71,2,10,12,43
"Bylsma, Dan",F,09/19/1970,"Grand Haven, Michigan",United States,429,19,43,62,184
"Byram, Bowen",D,06/13/2001,"Cranbrook, British Columbia",Canada,49,5,14,19,35
"Byram, Shawn",F,09/12/1968,"Neepawa, Manitoba",Canada,5,0,0,0,14
"Byron, Paul",F,04/27/1989,"Ottawa, Ontario",Canada,521,98,110,208,139
"Bødker, Mikkel",F,12/16/1989,Brøndby,Denmark,709,118,209,327,116
"Caamano, Nicholas",F,09/07/1998,"Ancaster, Ontario",Canada,36,1,2,3,21
"Caffery, Jack",F,06/30/1934,"Kingston, Ontario",Canada,57,3,2,5,22
"Caffery, Terry",F,04/01/1949,"Toronto, Ontario",Canada,14,0,0,0,0
"Caggiula, Drake",F,06/20/1994,"Pickering, Ontario",Canada,278,46,45,91,136
"Cahan, Larry",D,12/25/1933,"Thunder Bay, Ontario",Canada,671,38,92,130,696
"Cahill, Charles",F,01/04/1904,"Summerside, Prince Edward Island",Canada,32,0,1,1,9
"Cain, Herb",F,12/24/1912,"Newmarket, Ontario",Canada,572,206,192,398,177
"Cain, Jim 'Dutch'",D,03/22/1902,"Newmarket, Ontario",Canada,61,4,1,5,37
"Cairns, Don",F,10/08/1955,"Calgary, Alberta",Canada,9,0,1,1,2
"Cairns, Eric",D,06/27/1974,"Oakville, Ontario",Canada,457,10,32,42,1182
"Cajánek, Petr",F,08/18/1975,Zlin,Czech Republic,269,46,107,153,144
"Calder, Eric",D,06/26/1963,"Kitchener, Ontario",Canada,2,0,0,0,0
"Calder, Kyle",F,01/05/1979,"Mannville, Alberta",Canada,590,114,180,294,309
"Caldwell, Ryan",D,06/15/1981,"Deloraine, Manitoba",Canada,4,0,0,0,4
"Caley, Don",G,10/09/1945,"Dauphin, Manitoba",Canada,1,0,0,0,0
"Calladine, Norm",F,07/30/1916,"Peterborough, Ontario",Canada,63,19,29,48,8
"Callahan, Joe",D,12/20/1982,"Brockton, Massachusetts",United States,46,0,4,4,16
"Callahan, Mitch",F,08/17/1991,"Whittier, California",United States,5,0,0,0,0
"Callahan, Ryan",F,03/21/1985,"Rochester, New York",United States,757,186,200,386,428
"Callander, Drew",F,08/17/1956,"Regina, Saskatchewan",Canada,39,6,2,8,7
"Callander, Jock",F,04/23/1961,"Regina, Saskatchewan",Canada,109,22,29,51,116
"Callighen, Brett",F,05/15/1953,"Toronto, Ontario",Canada,160,56,89,145,132
"Callighen, Patsy",F,02/13/1906,"Toronto, Ontario",Canada,36,0,0,0,32
"Caloun, Jan",F,12/20/1972,Usti nad Labem,Czech Republic,24,8,6,14,2
"Calvert, Matt",F,12/24/1989,"Brandon, Manitoba",Canada,566,95,108,203,376
"Camazzola, James",F,01/05/1964,"Vancouver, British Columbia",Canada,3,0,0,0,0
"Camazzola, Tony",D,09/11/1962,"Burnaby, British Columbia",Canada,3,0,0,0,4
"Cameron, Al",D,10/21/1955,"Edmonton, Alberta",Canada,282,11,44,55,356
"Cameron, Billy",F,12/05/1896,"Timmins, Ontario",Canada,39,0,1,1,4
"Cameron, Craig",F,07/19/1945,"Edmonton, Alberta",Canada,552,87,65,152,196
"Cameron, Dave",F,07/29/1958,"Charlottetown, Prince Edward Island",Canada,168,25,28,53,238
"Cameron, Harry",D,02/06/1890,"Pembroke, Ontario",Canada,129,88,54,142,180
"Cameron, Scotty",F,11/05/1921,"Prince Albert, Saskatchewan",Canada,35,8,11,19,0
"Cammalleri, Mike",F,06/08/1982,"Richmond Hill, Ontario",Canada,906,294,348,642,425
"Campanale, Matt",D,02/14/1988,"Chester Springs, Pennsylvania",United States,1,0,0,0,2
"Campbell, Andrew",D,02/04/1988,"Caledonia, Ontario",Canada,42,0,2,2,12
"Campbell, Brian",D,05/23/1979,"Strathroy, Ontario",Canada,1082,87,417,504,277
"Campbell, Bryan",F,03/27/1944,"Sudbury, Ontario",Canada,261,35,71,106,74
"Campbell, Colin",D,01/28/1953,"London, Ontario",Canada,636,25,103,128,1295
"Campbell, Darcy",D,05/12/1984,"Airdrie, Alberta",Canada,1,0,0,0,0
"Campbell, Dave",D,04/27/1896,"Lachute, Quebec",Canada,2,0,0,0,0
"Campbell, Don",F,07/12/1925,"Drumheller, Alberta",Canada,17,1,3,4,6
"Campbell, Earl",F,07/23/1900,"Buckingham, Quebec",Canada,76,6,4,10,16
"Campbell, Gregory",F,12/17/1983,"London, Ontario",Canada,803,71,116,187,696
"Campbell, Jack",G,01/09/1992,"Port Huron, Michigan",United States,135,0,2,2,0
"Campbell, Jim",F,04/03/1973,"Worcester, Massachusetts",United States,285,61,75,136,268
"Campbell, Scott",D,06/22/1957,"Toronto, Ontario",Canada,80,4,21,25,243
"Campbell, Wade",D,01/02/1961,"Peace River, Alberta",Canada,213,9,27,36,305
"Campeau, Tod",F,06/04/1923,"Saint-Jérôme, Quebec",Canada,42,5,9,14,16
"Campedelli, Dominic",D,04/03/1964,"Cohasset, Massachusetts",United States,2,0,0,0,0
"Camper, Carter",F,07/06/1988,"Rocky River, Ohio",United States,3,1,0,1,0
"Campoli, Chris",D,07/09/1984,"North York, Ontario",Canada,440,35,111,146,200
"Cannone, Pat",F,08/09/1986,"Bayport, New York",United States,3,0,0,0,0
"Capobianco, Kyle",D,08/13/1997,"Mississauga, Ontario",Canada,59,3,7,10,42
"Caprice, Frank",G,05/02/1962,"Hamilton, Ontario",Canada,102,0,3,3,17
"Capuano, Dave",F,07/27/1968,"Warwick, Rhode Island",United States,104,17,38,55,56
"Capuano, Jack",D,07/07/1966,"Cranston, Rhode Island",United States,6,0,0,0,0
"Caputi, Luca",F,10/01/1988,"Toronto, Ontario",Canada,35,3,6,9,20
"Carbol, Leo",D,06/05/1908,"Ottawa, Ontario",Canada,6,0,1,1,4
"Carbonneau, Guy",F,03/18/1960,"Sept-Îles, Quebec",Canada,1318,260,403,663,820
"Carcillo, Daniel",F,01/28/1985,"King City, Ontario",Canada,429,48,52,100,1233
"Carcone, Michael",F,05/19/1996,"Whitby, Ontario",Canada,21,4,2,6,14
"Card, Mike",D,02/18/1986,"Kitchener, Ontario",Canada,4,0,0,0,0
"Cardin, Claude",F,02/17/1941,"Sorel-Tracy, Quebec",Canada,1,0,0,0,0
"Cardwell, Steve",F,08/13/1950,"Toronto, Ontario",Canada,53,9,11,20,35
"Carey, George",F,11/04/1892,"Glasgow, Scotland",United Kingdom,72,21,12,33,20
"Carey, Jim",G,05/31/1974,"Weymouth, Massachusetts",United States,172,0,1,1,8
"Carey, Matt",F,02/28/1992,"Hamilton, Ontario",Canada,2,1,0,1,2
"Carey, Paul",F,09/24/1988,"Weymouth, Massachusetts",United States,100,8,8,16,20
"Carkner, Matt",D,11/03/1980,"Winchester, Ontario",Canada,237,4,23,27,556
"Carkner, Terry",D,03/07/1966,"Smiths Falls, Ontario",Canada,858,42,188,230,1588
"Carle, Mathieu",D,09/30/1987,"Gatineau, Quebec",Canada,3,0,0,0,4
"Carle, Matt",D,09/25/1984,"Anchorage, Alaska",United States,730,45,238,283,251
"Carleton, Wayne",F,08/04/1946,"Sudbury, Ontario",Canada,278,55,73,128,170
"Carlin, Brian",F,06/13/1950,"Calgary, Alberta",Canada,5,1,0,1,0
"Carlo, Brandon",D,11/26/1996,"Colorado Springs, Colorado",United States,403,21,49,70,227
"Carlson, Jack",F,08/23/1954,"Virginia, Minnesota",United States,236,30,15,45,417
"Carlson, John",D,01/10/1990,"Natick, Massachusetts",United States,887,132,461,593,290
"Carlson, Kent",D,01/11/1962,"Concord, New Hampshire",United States,113,7,11,18,148
"Carlson, Steve",F,08/26/1955,"Virginia, Minnesota",United States,52,9,12,21,23
"Carlsson, Anders",F,11/25/1960,Gävle,Sweden,104,7,26,33,34
"Carlsson, Gabriel",D,01/02/1997,Örebro,Sweden,75,3,13,16,22
"Carlsson, Lucas",D,07/05/1997,Gävle,Sweden,58,3,8,11,12
"Carlyle, Randy",D,04/19/1956,"Sudbury, Ontario",Canada,1055,148,499,647,1400
"Carnbäck, Patrik",F,02/01/1968,Göteborg,Sweden,154,24,38,62,122
"Carney, Keith",D,02/03/1970,"Providence, Rhode Island",United States,1018,45,183,228,904
"Caron, Alain",F,04/27/1938,"Dolbeau, Quebec",Canada,61,9,13,22,18
"Caron, Jacques",G,04/21/1940,"Rouyn-Noranda, Quebec",Canada,72,0,1,1,2
"Caron, Jordan",F,11/02/1990,"Sayabec, Quebec",Canada,157,12,16,28,78
"Caron, Sebastien",G,06/25/1980,"Amqui, Quebec",Canada,95,0,1,1,12
"Carpenter, Bobby",F,07/13/1963,"Beverly, Massachusetts",United States,1178,320,408,728,919
"Carpenter, Eddie",D,06/15/1890,"Hartford, Michigan",United States,45,10,5,15,41
"Carpenter, Ryan",F,01/18/1991,"Oviedo, Florida",United States,308,26,43,69,106
"Carr, Alfred 'Red'",F,12/29/1916,"Winnipeg, Manitoba",Canada,5,0,1,1,4
"Carr, Daniel",F,11/01/1991,"Leduc, Alberta",Canada,117,16,21,37,28
"Carr, Gene",F,09/17/1951,"Nanaimo, British Columbia",Canada,465,79,136,215,365
"Carr, Lorne",F,07/02/1910,"Stoughton, Saskatchewan",Canada,580,204,227,431,132
"Carrick, Connor",D,04/13/1994,"Orland Park, Illinois",United States,241,13,36,49,157
"Carrick, Sam",F,02/04/1992,"Stouffville, Ontario",Canada,111,15,15,30,128
"Carrick, Trevor",D,07/04/1994,"Stouffville, Ontario",Canada,7,0,0,0,12
"Carrier, Alexandre",D,10/08/1996,"Québec City, Quebec",Canada,101,4,29,33,60
"Carrier, William",F,12/20/1994,"LaSalle, Quebec",Canada,318,36,38,74,158
"Carriere, Larry",D,01/30/1952,"Montréal, Quebec",Canada,366,16,74,90,462
"Carrigan, Gene",F,07/05/1907,"Edmonton, Alberta",Canada,37,2,1,3,13
"Carroll, Billy",F,01/19/1959,"Toronto, Ontario",Canada,322,30,54,84,113
"Carroll, George",D,06/03/1897,"Moncton, New Brunswick",Canada,19,0,0,0,9
"Carroll, Greg",F,11/10/1956,"Gimli, Manitoba",Canada,131,20,34,54,44
"Carruthers, Dwight",D,11/07/1944,"Lashburn, Saskatchewan",Canada,2,0,0,0,0
"Carse, Bill",F,05/29/1914,"Edmonton, Alberta",Canada,124,27,40,67,38
"Carse, Bob",F,07/19/1919,"Edmonton, Alberta",Canada,166,33,54,87,52
"Carson, Bill",F,11/25/1900,"Bracebridge, Ontario",Canada,159,54,27,81,121
"Carson, Brett",D,11/29/1985,"Regina, Saskatchewan",Canada,90,2,11,13,20
"Carson, Frank",F,01/12/1902,"Bracebridge, Ontario",Canada,248,42,48,90,170
"Carson, Gerald",D,10/10/1905,"Parry Sound, Ontario",Canada,260,12,10,22,203
"Carson, Jimmy",F,07/20/1968,"Southfield, Michigan",United States,626,275,286,561,254
"Carson, Lindsay",F,11/21/1960,"Oxbow, Saskatchewan",Canada,373,66,80,146,525
"Carter, Anson",F,06/06/1974,"Toronto, Ontario",Canada,674,202,219,421,229
"Carter, Billy",F,12/02/1937,"Cornwall, Ontario",Canada,16,0,0,0,0
"Carter, Jeff",F,01/01/1985,"London, Ontario",Canada,1170,418,389,807,593
"Carter, John",F,05/03/1963,"Winchester, Massachusetts",United States,244,40,50,90,201
"Carter, Lyle",G,04/29/1945,"Truro, Nova Scotia",Canada,15,0,0,0,2
"Carter, Ron",F,03/14/1958,"Montréal, Quebec",Canada,2,0,0,0,0
"Carter, Ryan",F,08/03/1983,"White Bear Lake, Minnesota",United States,473,41,52,93,444
"Caruso, Michael",D,07/05/1988,"Mississauga, Ontario",Canada,2,0,0,0,0
"Carveth, Joe",F,03/21/1918,"Regina, Saskatchewan",Canada,502,150,187,337,81
"Casey, Jon",G,08/29/1962,"Grand Rapids, Minnesota",United States,425,0,13,13,126
"Cashman, Wayne",F,06/24/1945,"Kingston, Ontario",Canada,1027,277,516,793,1039
"Casselman, Mike",F,09/23/1968,"Morrisburg, Ontario",Canada,3,0,0,0,0
"Cassels, Andrew",F,07/23/1969,"Bramalea, Ontario",Canada,1015,204,528,732,410
"Cassidy, Bruce",D,05/20/1965,"Ottawa, Ontario",Canada,36,4,13,17,10
"Cassidy, Tom",F,03/15/1952,"Blind River, Ontario",Canada,26,3,4,7,15
"Cassivi, Frederic",G,06/12/1975,"Sorel-Tracy, Quebec",Canada,13,0,0,0,0
"Cassolato, Tony",F,05/07/1956,"Guelph, Ontario",Canada,23,1,6,7,4
"Catenacci, Dan",F,03/09/1993,"Newmarket, Ontario",Canada,12,0,0,0,0
"Cates, Jackson",F,09/28/1997,"Stillwater, Minnesota",United States,15,1,1,2,0
"Cates, Noah",F,02/05/1999,"Stillwater, Minnesota",United States,16,5,4,9,4
"Caufield, Cole",F,01/02/2001,"Mosinee, Wisconsin",United States,77,27,21,48,12
"Caufield, Jay",F,07/17/1960,"Philadelphia, Pennsylvania",United States,208,5,8,13,759
"Cavallini, Gino",F,11/24/1962,"Toronto, Ontario",Canada,593,114,159,273,507
"Cavallini, Paul",D,10/13/1965,"Toronto, Ontario",Canada,564,56,177,233,750
"Cavanagh, Tom",F,03/24/1982,"Warwick, Rhode Island",United States,18,1,2,3,4
"Cave, Colby",F,12/26/1994,"North Battleford, Saskatchewan",Canada,67,4,5,9,22
"Cechmánek, Roman",G,03/02/1971,Zlin,Czech Republic,212,0,1,1,24
"Ceci, Cody",D,12/21/1993,"Ottawa, Ontario",Canada,627,42,129,171,132
"Cehlarik, Peter",F,08/02/1995,Žilina,Slovakia,40,5,6,11,10
"Centomo, Sebastien",G,03/26/1981,"Montréal, Quebec",Canada,1,0,0,0,0
"Ceresino, Ray",F,04/24/1929,"Thunder Bay, Ontario",Canada,12,1,1,2,2
"Cernak, Erik",D,05/28/1997,Kosice,Slovakia,226,16,43,59,201
"Cernik, Frantisek",F,06/03/1953,Novy Jicin,Czech Republic,49,5,4,9,13
"Cervenka, Roman",F,12/10/1985,Prague,Czech Republic,39,9,8,17,14
"Chabot, Frederic",G,02/12/1968,"Hebertville-Station, Quebec",Canada,32,0,0,0,2
"Chabot, John",F,05/18/1962,"Summerside, Prince Edward Island",Canada,508,84,228,312,85
"Chabot, Lorne",G,10/05/1900,"Montréal, Quebec",Canada,412,0,0,0,10
"Chabot, Thomas",D,01/30/1997,"Sainte-Marie-de-Beauce, Quebec",Canada,313,42,146,188,150
"Chad, John",F,09/16/1919,"Provost, Alberta",Canada,80,15,22,37,29
"Chadwick, Ed",G,05/08/1933,"Fergus, Ontario",Canada,184,0,0,0,0
"Chaffee, Mitchell",F,01/26/1998,"Rockford, Michigan",United States,2,0,0,0,0
"Chalmers, William",F,01/24/1934,"Stratford, Ontario",Canada,1,0,0,0,0
"Chalupa, Milan",D,07/04/1953,Oudolen,Czech Republic,14,0,5,5,6
"Chamberlain, Erwin",F,02/14/1915,"Shawville, Quebec",Canada,510,100,175,275,789
"Chambers, Shawn",D,10/11/1966,"Sterling Heights, Michigan",United States,625,50,185,235,364
"Champagne, Andre",F,09/19/1943,"Ottawa, Ontario",Canada,2,0,0,0,0
"Champoux, Bob",G,12/02/1942,"Saint Hillaire, Quebec",Canada,17,0,0,0,0
"Chapdelaine, Rene",D,09/27/1966,"Weyburn, Saskatchewan",Canada,32,0,2,2,32
"Chapman, Art",F,05/29/1906,"Winnipeg, Manitoba",Canada,431,62,176,238,136
"Chapman, Blair",F,06/13/1956,"Lloydminster, Saskatchewan",Canada,402,106,125,231,158
"Chapman, Brian",D,02/10/1968,"Brockville, Ontario",Canada,3,0,0,0,29
"Chaput, Michael",F,04/09/1992,"Montréal, Quebec",Canada,182,6,16,22,88
"Chara, Zdeno",D,03/18/1977,Trencín,Slovakia,1680,209,471,680,2085
"Charbonneau, Jose",F,11/21/1966,"Ferme-Neuve, Quebec",Canada,71,9,13,22,67
"Charbonneau, Stephane",F,06/27/1970,"Sainte-Adele, Quebec",Canada,2,0,0,0,0
"Charlebois, Bob",F,05/27/1944,"Cornwall, Ontario",Canada,7,1,0,1,0
"Charlesworth, Todd",D,03/22/1965,"Calgary, Alberta",Canada,93,3,9,12,47
"Charpentier, Sebastien",G,04/18/1977,"Drummondville, Quebec",Canada,26,0,0,0,0
"Charron, Eric",D,01/14/1970,"Verdun, Quebec",Canada,130,2,7,9,127
"Charron, Guy",F,01/24/1949,"Verdun, Quebec",Canada,734,221,309,530,146
"Chartier, Dave",F,02/15/1961,"St. Lazare, Manitoba",Canada,1,0,0,0,0
"Chartier, Rourke",F,04/03/1996,"Saskatoon, Saskatchewan",Canada,13,1,0,1,2
"Chartrand, Brad",F,12/14/1974,"Winnipeg, Manitoba",Canada,215,25,25,50,122
"Chartraw, Rick",D,07/13/1954,Caracas,Venezuela,420,28,64,92,399
"Chase, Kelly",F,10/25/1967,"Porcupine Plain, Saskatchewan",Canada,458,17,36,53,2017
"Chasse, Denis",F,02/07/1970,"Montréal, Quebec",Canada,132,11,14,25,292
"Chatfield, Jalen",D,05/15/1996,"Ypsilanti, Michigan",United States,34,0,4,4,20
"Chebaturkin, Vladimir",D,04/23/1975,Tyumen,Russia,62,2,7,9,52
"Check, Lude",F,05/22/1919,"Brandon, Manitoba",Canada,27,6,2,8,4
"Cheechoo, Jonathan",F,07/15/1980,"Moose Factory, Ontario",Canada,501,170,135,305,324
"Cheevers, Gerry",G,12/07/1940,"St. Catharines, Ontario",Canada,418,0,11,11,214
"Chekhovich, Ivan",F,01/04/1999,Yekaterinburg,Russia,4,0,1,1,0
"Chelios, Chris",D,01/25/1962,"Chicago, Illinois",United States,1651,185,763,948,2891
"Chelios, Jake",D,03/08/1991,"Bloomfield Hills, Michigan",United States,5,0,0,0,2
"Chernoff, Mike",F,05/13/1946,"Yorkton, Saskatchewan",Canada,1,0,0,0,0
"Chernomaz, Rich",F,09/01/1963,"Selkirk, Manitoba",Canada,51,9,7,16,18
"Cherry, Dick",D,03/28/1937,"Kingston, Ontario",Canada,145,12,10,22,45
"Chervyakov, Denis",D,04/20/1970,Saint Petersburg,Russia,2,0,0,0,2
"Cheveldae, Tim",G,02/15/1968,"Melville, Saskatchewan",Canada,340,0,16,16,18
"Chevrefils, Real",F,05/02/1932,"Timmins, Ontario",Canada,387,104,97,201,181
"Chevrier, Alain",G,04/23/1961,"Cornwall, Ontario",Canada,234,0,11,11,35
"Chiarot, Ben",D,05/09/1991,"Hamilton, Ontario",Canada,489,31,87,118,351
"Chiasson, Alex",F,10/01/1990,"Montréal, Quebec",Canada,631,114,110,224,353
"Chiasson, Steve",D,04/14/1967,"Barrie, Ontario",Canada,751,93,305,398,1107
"Chibirev, Igor",F,04/19/1968,Kiev,Ukraine,45,7,12,19,2
"Chibisov, Andrei",F,02/26/1993,Prokopyevsk,Russia,2,0,0,0,0
"Chicoine, Dan",F,11/30/1957,"Sherbrooke, Quebec",Canada,31,1,2,3,12
"Chimera, Jason",F,05/02/1979,"Edmonton, Alberta",Canada,1107,186,229,415,892
"Chinakhov, Yegor",F,02/01/2001,Omsk,Russia,62,7,7,14,16
"Chinnick, Rick",F,08/15/1953,"Chatham, Ontario",Canada,4,0,2,2,0
"Chiodo, Andy",G,04/25/1983,"Toronto, Ontario",Canada,8,0,0,0,0
"Chipchura, Kyle",F,02/19/1986,"Westlock, Alberta",Canada,482,31,73,104,376
"Chipperfield, Ron",F,03/28/1954,"Brandon, Manitoba",Canada,83,22,24,46,34
"Chisholm, Art",F,11/11/1934,"Arlington, Massachusetts",United States,3,0,0,0,0
"Chisholm, Colin",D,02/25/1963,"Edmonton, Alberta",Canada,1,0,0,0,0
"Chisholm, Declan",D,01/12/2000,"Bowmanville, Ontario",Canada,2,0,0,0,0
"Chisholm, Lex",F,04/01/1915,"Galt, Ontario",Canada,61,10,8,18,30
"Chistov, Stanislav",F,04/17/1983,Chelyabinsk,Russia,196,19,42,61,116
"Chlapik, Filip",F,06/03/1997,Prague,Czech Republic,57,5,6,11,18
"Chmelevski, Alexander",F,06/09/1999,"Huntington Beach, California",United States,24,0,10,10,6
"Cholowski, Dennis",D,02/15/1998,"Langley, British Columbia",Canada,115,10,20,30,28
"Chorney, Marc",D,11/08/1959,"Sudbury, Ontario",Canada,210,8,27,35,209
"Chorney, Taylor",D,04/27/1987,"Thunder Bay, Ontario",Canada,166,4,18,22,56
"Chorske, Tom",F,09/18/1966,"Minneapolis, Minnesota",United States,596,115,122,237,225
"Chouinard, Eric",F,07/08/1980,"Atlanta, Georgia",United States,90,11,11,22,16
"Chouinard, Gene",D,01/05/1902,"Ottawa, Ontario",Canada,8,0,0,0,0
"Chouinard, Guy",F,10/20/1956,"Québec City, Quebec",Canada,578,205,370,575,120
"Chouinard, Marc",F,05/06/1977,"Charlesbourg, Quebec",Canada,320,37,41,78,123
"Chouinard, Mathieu",G,04/11/1980,"Laval, Quebec",Canada,1,0,0,0,0
"Christensen, Erik",F,12/17/1983,"Edmonton, Alberta",Canada,387,68,95,163,162
"Christian, Dave",F,05/13/1959,"Warroad, Minnesota",United States,1009,340,433,773,284
"Christian, Jeff",F,07/30/1970,"Burlington, Ontario",Canada,18,2,2,4,17
"Christiansen, Jacob",D,09/12/1999,"West Vancouver, British Columbia",Canada,8,1,0,1,0
"Christie, Mike",D,12/20/1949,"Big Spring, Texas",United States,412,15,101,116,550
"Christie, Ryan",F,07/03/1978,"Beamsville, Ontario",Canada,7,0,0,0,0
"Christoff, Steve",F,01/23/1958,"Richfield, Minnesota",United States,248,77,64,141,108
"Chrystal, Bob",D,04/03/1930,"Winnipeg, Manitoba",Canada,132,11,14,25,112
"Chubarov, Artem",F,12/13/1979,Nizhny Novgorod,Russia,228,25,33,58,40
"Chucko, Kris",F,03/13/1986,"Burnaby, British Columbia",Canada,2,0,0,0,2
"Church, Brad",F,11/14/1976,"Dauphin, Manitoba",Canada,2,0,0,0,0
"Church, Jack",D,05/24/1915,"Kamsack, Saskatchewan",Canada,142,4,19,23,154
"Churla, Shane",F,06/24/1965,"Fernie, British Columbia",Canada,488,26,45,71,2301
"Chychrun, Jakob",D,03/31/1998,"Boca Raton, Florida",United States,337,53,89,142,218
"Chychrun, Jeff",D,05/03/1966,"LaSalle, Quebec",Canada,262,3,22,25,742
"Chynoweth, Dean",D,10/30/1968,"Calgary, Alberta",Canada,241,4,18,22,667
"Chytil, Filip",F,09/05/1999,Kromeriz,Czech Republic,253,42,51,93,46
"Chyzowski, Dave",F,07/11/1971,"Edmonton, Alberta",Canada,126,15,16,31,144
"Ciavaglia, Peter",F,07/15/1969,"Albany, New York",United States,5,0,0,0,0
"Cibak, Martin",F,05/17/1980,Liptovsky Mikulas,Slovakia,154,5,18,23,60
"Ciccarelli, Dino",F,02/08/1960,"Sarnia, Ontario",Canada,1232,608,592,1200,1425
"Ciccone, Enrico",D,04/10/1970,"Montréal, Quebec",Canada,374,10,18,28,1469
"Cichocki, Chris",F,09/17/1963,"Detroit, Michigan",United States,68,11,12,23,27
"Ciernik, Ivan",F,10/30/1977,Levice,Slovakia,89,12,14,26,32
"Cierny, Jozef",F,05/13/1974,Zvolen,Slovakia,1,0,0,0,0
"Ciesla, Hank",F,10/15/1934,"St. Catharines, Ontario",Canada,271,26,51,77,85
"Ciger, Zdeno",F,10/19/1969,Martin,Slovakia,352,94,134,228,101
"Cimellaro, Tony",F,06/14/1971,"Kingston, Ontario",Canada,2,0,0,0,0
"Cimetta, Robert",F,02/15/1970,"Toronto, Ontario",Canada,103,16,16,32,66
"Cirella, Joe",D,05/09/1963,"Hamilton, Ontario",Canada,828,64,211,275,1446
"Cirelli, Anthony",F,07/15/1997,"Woodbridge, Ontario",Canada,294,66,93,159,150
"Cirone, Jason",F,02/21/1971,"Toronto, Ontario",Canada,3,0,0,0,2
"Cisár, Marián",F,02/25/1978,Bratislava,Slovakia,73,13,17,30,57
"Cizikas, Casey",F,02/27/1991,"Toronto, Ontario",Canada,664,91,110,201,310
"Clackson, Kim",D,02/13/1955,"Saskatoon, Saskatchewan",Canada,106,0,8,8,370
"Claesson, Fredrik",D,11/24/1992,Stockholm,Sweden,170,7,21,28,62
"Clague, Kale",D,06/05/1998,"Lloydminster, Alberta",Canada,58,2,14,16,26
"Clancy, King",D,02/25/1903,"Ottawa, Ontario",Canada,592,137,150,287,914
"Clancy, Terry",F,04/02/1943,"Ottawa, Ontario",Canada,93,6,6,12,39
"Clapper, Dit",F,02/09/1907,"Newmarket, Ontario",Canada,835,229,248,477,452
"Clark, Brett",D,12/23/1976,"Wapella, Saskatchewan",Canada,689,45,141,186,293
"Clark, Chris",F,03/08/1976,"South Windsor, Connecticut",United States,607,103,111,214,700
"Clark, Dan",D,11/03/1957,"Toronto, Ontario",Canada,4,0,1,1,6
"Clark, Dean",D,01/16/1964,"Edmonton, Alberta",Canada,1,0,0,0,0
"Clark, Gordie",F,05/31/1952,"Glasgow, Scotland",United Kingdom,8,0,1,1,0
"Clark, Mat",D,10/17/1990,"Lakewood, Colorado",United States,9,0,1,1,6
"Clark, Nobby",D,06/18/1897,"Orillia, Ontario",Canada,2,0,0,0,0
"Clark, Wendel",F,10/25/1966,"Kelvington, Saskatchewan",Canada,793,330,234,564,1690
"Clarke, Bobby",F,08/13/1949,"Flin Flon, Manitoba",Canada,1144,358,852,1210,1453
"Clarke, Dale",D,03/23/1978,"Belleville, Ontario",Canada,3,0,0,0,0
"Clarke, Noah",F,06/11/1979,"La Verne, California",United States,21,3,1,4,4
"Clarkson, David",F,03/31/1984,"Toronto, Ontario",Canada,570,114,86,200,992
"Classen, Greg",F,08/24/1977,"Aylsham, Saskatchewan",Canada,90,7,10,17,48
"Cleary, Daniel",F,12/18/1978,"Carbonear, Newfoundland and Labrador",Canada,938,165,222,387,492
"Cleghorn, Odie",F,09/19/1891,"Montréal, Quebec",Canada,182,94,35,129,150
"Cleghorn, Sprague",D,03/11/1890,"Montréal, Quebec",Canada,262,85,63,148,549
"Clement, Bill",F,12/20/1950,"Buckingham, Quebec",Canada,719,148,208,356,383
"Clemmensen, Scott",G,07/23/1977,"Des Moines, Iowa",United States,191,0,3,3,4
"Clendening, Adam",D,10/26/1992,"Niagara Falls, New York",United States,90,4,20,24,49
"Cliche, Marc-Andre",F,03/23/1987,"Rouyn-Noranda, Quebec",Canada,151,3,11,14,34
"Clifford, Chris",G,05/26/1966,"Kingston, Ontario",Canada,2,0,0,0,0
"Clifford, Kyle",F,01/13/1991,"Ayr, Ontario",Canada,751,66,77,143,903
"Clifton, Connor",D,04/28/1995,"Matawan, New Jersey",United States,154,5,15,20,97
"Climie, Matt",G,02/11/1983,"Leduc, Alberta",Canada,5,0,0,0,0
"Cline, Bruce",F,11/14/1931,"Massawippi, Quebec",Canada,30,2,3,5,10
"Clippingdale, Steve",F,04/29/1956,"Vancouver, British Columbia",Canada,19,1,2,3,9
"Clitsome, Grant",D,04/14/1985,"Gloucester, Ontario",Canada,205,15,56,71,98
"Cloutier, Dan",G,04/22/1976,"Mont-Laurier, Quebec",Canada,351,0,5,5,147
"Cloutier, Jacques",G,01/03/1960,"Rouyn-Noranda, Quebec",Canada,255,0,7,7,51
"Cloutier, Real",F,07/30/1956,"Saint-Emile, Quebec",Canada,318,146,198,344,119
"Cloutier, Rejean",D,02/15/1960,"Windsor, Quebec",Canada,5,0,2,2,2
"Cloutier, Roland",F,10/06/1957,"Rouyn-Noranda, Quebec",Canada,34,8,9,17,2
"Cloutier, Sylvain",F,02/13/1974,"Mont-Laurier, Quebec",Canada,7,0,0,0,0
"Clowe, Ryane",F,09/30/1982,"St. John's, Newfoundland and Labrador",Canada,491,112,197,309,618
"Clune, Rich",F,04/25/1987,"Toronto, Ontario",Canada,139,7,15,22,327
"Clune, Wally",D,02/20/1930,"Toronto, Ontario",Canada,5,0,0,0,6
"Clutterbuck, Cal",F,11/18/1987,"Welland, Ontario",Canada,933,130,132,262,636
"Clymer, Ben",D,04/11/1978,"Bloomington, Minnesota",United States,438,52,77,129,367
"Coalter, Gary",F,07/08/1950,"Toronto, Ontario",Canada,34,2,4,6,2
"Coates, Steve",F,07/02/1950,"Toronto, Ontario",Canada,5,1,0,1,24
"Coburn, Braydon",D,02/27/1985,"Calgary, Alberta",Canada,983,49,185,234,720
"Cochrane, Glen",D,01/29/1958,"Cranbrook, British Columbia",Canada,411,17,72,89,1556
"Coffey, Paul",D,06/01/1961,"Weston, Ontario",Canada,1409,396,1135,1531,1802
"Coflin, Hugh",D,12/15/1928,"Blaine Lake, Saskatchewan",Canada,31,0,3,3,33
"Coghlan, Dylan",D,02/19/1998,"Duncan, British Columbia",Canada,88,6,13,19,20
"Cogliano, Andrew",F,06/14/1987,"Toronto, Ontario",Canada,1140,174,252,426,389
"Cohen, Colby",D,04/25/1989,"Villanova, Pennsylvania",United States,3,0,0,0,4
"Colaiacovo, Carlo",D,01/27/1983,"Toronto, Ontario",Canada,470,34,123,157,231
"Colborne, Joe",F,01/30/1990,"Calgary, Alberta",Canada,295,42,72,114,144
"Cole, Danton",F,01/10/1967,"Pontiac, Michigan",United States,318,58,60,118,125
"Cole, Erik",F,11/06/1978,"Oswego, New York",United States,892,265,267,532,659
"Cole, Ian",D,02/21/1989,"Ann Arbor, Michigan",United States,670,29,136,165,622
"Coleman, Blake",F,11/28/1991,"Plano, Texas",United States,382,87,72,159,301
"Coleman, Gerald",G,04/03/1985,"Romeoville, Illinois",United States,2,0,0,0,0
"Colley, Kevin",F,01/04/1979,"New Haven, Connecticut",United States,16,0,0,0,52
"Colley, Tom",F,08/21/1953,"Toronto, Ontario",Canada,1,0,0,0,2
"Collings, Norman",F,05/06/1910,"Bradford, Ontario",Canada,1,0,1,1,0
"Collins, Bill",F,07/13/1943,"Ottawa, Ontario",Canada,768,157,154,311,415
"Collins, Rob",F,03/15/1978,"Whitby, Ontario",Canada,8,1,1,2,0
"Collins, Sean",D,10/30/1983,"Troy, Michigan",United States,21,2,1,3,12
"Collins, Sean",F,12/29/1988,"Saskatoon, Saskatchewan",Canada,21,0,3,3,10
"Colliton, Jeremy",F,01/13/1985,"Blackie, Alberta",Canada,57,3,3,6,26
"Collyard, Bob",F,10/16/1949,"Hibbing, Minnesota",United States,10,1,3,4,4
"Colman, Mike",D,08/04/1968,"Stoneham, Massachusetts",United States,15,0,1,1,32
"Colton, Ross",F,09/11/1996,"Robbinsville, New Jersey",United States,109,31,20,51,40
"Colville, Mac",F,01/08/1916,"Edmonton, Alberta",Canada,353,71,102,173,130
"Colville, Neil",F,08/04/1914,"Edmonton, Alberta",Canada,465,100,166,266,213
"Colvin, Les",G,02/08/1921,"Oshawa, Ontario",Canada,1,0,0,0,0
"Colwill, Les",F,01/01/1935,"Diwide, Saskatchewan",Canada,69,7,6,13,16
"Comeau, Blake",F,02/18/1986,"Meadow Lake, Saskatchewan",Canada,909,141,193,334,573
"Comeau, Rey",F,10/25/1948,"Montréal, Quebec",Canada,564,98,141,239,175
"Commodore, Mike",D,11/07/1979,"Fort Saskatchewan, Alberta",Canada,484,23,83,106,683
"Compher, J.T.",F,04/08/1995,"Northbrook, Illinois",United States,341,71,71,142,117
"Comrie, Eric",G,07/06/1995,"Edmonton, Alberta",Canada,28,0,1,1,0
"Comrie, Mike",F,09/11/1980,"Edmonton, Alberta",Canada,589,168,197,365,443
"Comrie, Paul",F,02/07/1977,"Edmonton, Alberta",Canada,15,1,2,3,4
"Comtois, Maxime",F,01/08/1999,"Longueuil, Quebec",Canada,146,29,38,67,117
"Conacher, Brian",F,08/31/1941,"Toronto, Ontario",Canada,155,28,28,56,84
"Conacher, Charlie",F,12/20/1909,"Toronto, Ontario",Canada,461,224,172,396,523
"Conacher, Cory",F,12/14/1989,"Burlington, Ontario",Canada,193,28,47,75,118
"Conacher, Jim",F,05/05/1921,"Motherwell, Scotland",United Kingdom,328,85,117,202,87
"Conacher, Lionel",D,05/24/1901,"Toronto, Ontario",Canada,498,78,108,186,890
"Conacher, Pat",F,05/01/1959,"Edmonton, Alberta",Canada,521,63,76,139,235
"Conacher, Pete",F,07/29/1932,"Toronto, Ontario",Canada,229,47,39,86,55
"Conacher, Roy",F,10/05/1916,"Toronto, Ontario",Canada,490,226,201,427,88
"Conboy, Tim",D,03/22/1982,"Farmington, Minnesota",United States,59,0,6,6,121
"Condon, Mike",G,04/27/1990,"Holliston, Massachusetts",United States,129,0,2,2,4
"Condra, Erik",F,08/06/1986,"Trenton, Michigan",United States,372,40,59,99,176
"Conklin, Ty",G,03/30/1976,"Phoenix, Arizona",United States,215,0,3,3,37
"Conn, Maitland 'Red'",F,10/25/1904,"Hartney, Manitoba",Canada,96,9,28,37,22
"Conn, Rob",F,09/03/1968,"Calgary, Alberta",Canada,30,2,5,7,20
"Connauton, Kevin",D,02/23/1990,"Edmonton, Alberta",Canada,360,28,52,80,188
"Connell, Alex",G,02/08/1900,"Ottawa, Ontario",Canada,418,0,0,0,4
"Connelly, Bert",F,04/22/1909,"Montréal, Quebec",Canada,87,13,15,28,37
"Connelly, Wayne",F,12/16/1939,"Rouyn-Noranda, Quebec",Canada,543,133,174,307,154
"Conner, Chris",F,12/23/1983,"Westland, Michigan",United States,180,22,28,50,38
"Connolly, Brett",F,05/02/1992,"Campbell River, British Columbia",Canada,536,101,94,195,241
"Connolly, Mike",F,07/03/1989,"Calgary, Alberta",Canada,2,0,0,0,2
"Connolly, Tim",F,05/07/1981,"Syracuse, New York",United States,697,131,300,431,300
"Connor, Cam",F,08/10/1954,"Winnipeg, Manitoba",Canada,89,9,22,31,256
"Connor, Harry",F,12/03/1904,"Ottawa, Ontario",Canada,132,16,5,21,149
"Connor, Kyle",F,12/09/1996,"Shelby Township, Michigan",United States,384,178,166,344,88
"Connors, Bobby",D,10/19/1904,"Glasgow, Scotland",United Kingdom,78,17,10,27,108
"Conroy, Al",F,01/17/1966,"Calgary, Alberta",Canada,114,9,14,23,156
"Conroy, Craig",F,09/04/1971,"Potsdam, New York",United States,1009,182,360,542,603
"Contini, Joe",F,01/29/1957,"Galt, Ontario",Canada,68,17,21,38,34
"Convery, Brandon",F,02/04/1974,"Kingston, Ontario",Canada,72,9,19,28,36
"Convey, Eddie",F,12/16/1910,"Toronto, Ontario",Canada,34,1,1,2,35
"Cook, Alex 'Bud'",F,11/20/1907,"Kingston, Ontario",Canada,50,5,4,9,22
"Cook, Bill",F,10/09/1895,"Brantford, Ontario",Canada,475,228,138,366,386
"Cook, Bob",F,01/06/1946,"Sudbury, Ontario",Canada,72,13,9,22,22
"Cook, Bun",F,09/18/1903,"Kingston, Ontario",Canada,477,158,146,304,458
"Cook, Lloyd",D,03/21/1890,"Lynden, Ontario",Canada,4,1,0,1,0
"Cook, Tom",F,05/07/1907,"Thunder Bay, Ontario",Canada,348,76,98,174,180
"Cooke, Matt",F,09/07/1978,"Belleville, Ontario",Canada,1046,167,231,398,1135
"Cooper, Carson",F,07/17/1899,"Cornwall, Ontario",Canada,295,110,62,172,126
"Cooper, David",D,11/02/1973,"Ottawa, Ontario",Canada,30,3,7,10,24
"Cooper, Ed",F,08/28/1960,"Loon Lake, Saskatchewan",Canada,49,8,7,15,46
"Cooper, Hal",F,08/29/1915,"New Liskeard, Ontario",Canada,8,0,0,0,2
"Cooper, Joe",D,12/14/1914,"Winnipeg, Manitoba",Canada,420,30,67,97,450
"Copley, Pheonix",G,01/18/1992,"North Pole, Alaska",United States,31,0,1,1,0
"Copp, Andrew",F,07/08/1994,"Ann Arbor, Michigan",United States,483,82,120,202,90
"Copp, Bob",D,11/15/1918,"Port Elgin, New Brunswick",Canada,30,3,9,12,26
"Corazzini, Carl",F,04/21/1979,"Framingham, Massachusetts",United States,19,2,1,3,2
"Corbeau, Bert",D,02/09/1894,"Penetanguishene, Ontario",Canada,258,63,48,111,665
"Corbet, Rene",F,06/25/1973,"Victoriaville, Quebec",Canada,362,58,74,132,420
"Corcoran, Norm",F,08/15/1931,"Toronto, Ontario",Canada,29,1,3,4,21
"Coreau, Jared",G,11/05/1991,"Perth, Ontario",Canada,21,0,0,0,0
"Corkum, Bob",F,12/18/1967,"Salisbury, Massachusetts",United States,720,97,103,200,281
"Cormier, Patrice",F,06/14/1990,"Moncton, New Brunswick",Canada,52,1,4,5,18
"Cormier, Roger",F,03/23/1905,"Montréal, Quebec",Canada,1,0,0,0,0
"Cornet, Philippe",F,03/28/1990,"Val-Senneville, Quebec",Canada,2,0,1,1,0
"Cornforth, Mark",D,11/13/1972,"Montréal, Quebec",Canada,6,0,0,0,4
"Corrado, Frank",D,03/26/1993,"Woodbridge, Ontario",Canada,76,3,5,8,40
"Corrente, Matthew",D,03/17/1988,"Mississauga, Ontario",Canada,34,0,6,6,68
"Corrigan, Charles",F,05/22/1916,"Moosomin, Saskatchewan",Canada,18,2,2,4,2
"Corrigan, Mike",F,01/11/1946,"Ottawa, Ontario",Canada,594,152,195,347,698
"Corrinet, Chris",F,10/29/1978,"Derby, Connecticut",United States,8,0,1,1,6
"Corriveau, Andre",F,05/15/1928,"Grand-Mere, Quebec",Canada,3,0,1,1,0
"Corriveau, Yvon",F,02/08/1967,"Welland, Ontario",Canada,280,48,40,88,308
"Corsi, Jim",G,06/09/1954,"Montréal, Quebec",Canada,26,0,3,3,6
"Corso, Daniel",F,04/03/1978,"Montréal, Quebec",Canada,77,14,11,25,20
"Corson, Shayne",F,08/13/1966,"Barrie, Ontario",Canada,1156,273,420,693,2357
"Corvo, Joe",D,06/20/1977,"Oak Park, Illinois",United States,708,92,218,310,241
"Cory, Ross",D,02/04/1957,"Calgary, Alberta",Canada,51,2,10,12,41
"Cossette, Jacques",F,06/20/1954,"Rouyn-Noranda, Quebec",Canada,64,8,6,14,29
"Costello, Les",F,02/16/1928,"Timmins, Ontario",Canada,15,2,3,5,11
"Costello, Murray",F,02/24/1934,"Timmins, Ontario",Canada,163,13,19,32,54
"Costello, Rich",F,06/27/1963,"Framingham, Massachusetts",United States,12,2,2,4,2
"Cotch, Charlie",F,02/21/1900,"Sarnia, Ontario",Canada,12,1,0,1,0
"Cote, Alain",D,04/14/1967,"Montmagny, Quebec",Canada,119,2,18,20,124
"Cote, Alain",F,05/03/1957,"Matane, Quebec",Canada,696,103,190,293,383
"Cote, Jean-Philippe",D,04/22/1982,"Charlesbourg, Quebec",Canada,27,0,4,4,26
"Cote, Patrick",F,01/24/1975,"LaSalle, Quebec",Canada,105,1,2,3,377
"Cote, Ray",F,05/31/1961,"Pincher Creek, Alberta",Canada,15,0,0,0,4
"Cote, Riley",F,03/16/1982,"Winnipeg, Manitoba",Canada,156,1,6,7,411
"Cote, Sylvain",D,01/19/1966,"Québec City, Quebec",Canada,1171,122,313,435,545
"Cotter, Paul",F,11/16/1999,"Canton, Michigan",United States,7,2,0,2,6
"Cotton, Harold",F,11/05/1902,"Nanticoke, Ontario",Canada,503,101,104,205,449
"Coughlin, John",F,06/06/1892,"Douro-Dummer, Ontario",Canada,18,2,0,2,3
"Coulis, Tim",F,02/24/1958,"Kenora, Ontario",Canada,47,4,5,9,138
"Coulombe, Patrick",D,04/23/1985,"Saint-Fabien, Quebec",Canada,7,0,1,1,4
"Coulson, D'Arcy",F,02/17/1908,"Sudbury, Ontario",Canada,28,0,0,0,103
"Coulter, Arthur",D,05/31/1909,"Winnipeg, Manitoba",Canada,458,31,82,113,546
"Coulter, Neal",F,01/02/1963,"Toronto, Ontario",Canada,26,5,5,10,11
"Coulter, Tom",D,04/21/1911,"Winnipeg, Manitoba",Canada,2,0,0,0,0
"Cournoyer, Yvan",F,11/22/1943,"Drummondville, Quebec",Canada,968,428,435,863,233
"Courteau, Maurice",G,02/18/1920,"Québec City, Quebec",Canada,6,0,0,0,0
"Courteau, Yves",F,04/25/1964,"Montréal, Quebec",Canada,22,2,5,7,4
"Courtenay, Ed",F,02/02/1968,"Verdun, Quebec",Canada,44,7,13,20,10
"Courtnall, Geoff",F,08/18/1962,"Duncan, British Columbia",Canada,1048,367,432,799,1463
"Courtnall, Russ",F,06/02/1965,"Duncan, British Columbia",Canada,1029,297,447,744,557
"Courville, Larry",F,04/02/1975,"Timmins, Ontario",Canada,33,1,2,3,16
"Cousineau, Marcel",G,04/30/1973,"Delson, Quebec",Canada,26,0,1,1,0
"Cousins, Nick",F,07/20/1993,"Belleville, Ontario",Canada,444,55,83,138,210
"Coutu, Billy",D,03/01/1892,"North Bay, Ontario",Canada,247,33,23,56,502
"Couture, Gerry",F,08/06/1925,"Saskatoon, Saskatchewan",Canada,385,86,70,156,87
"Couture, Logan",F,03/28/1989,"Guelph, Ontario",Canada,845,296,337,633,232
"Couture, Rosario",F,07/24/1905,"St. Boniface, Manitoba",Canada,329,48,55,103,185
"Couturier, Sean",F,12/07/1992,"Phoenix, Arizona",United States,721,180,280,460,277
"Couturier, Sylvain",F,04/23/1968,"Greenfield Park, Quebec",Canada,33,4,5,9,4
"Cowan, Jeff",F,09/27/1976,"Scarborough, Ontario",Canada,413,47,34,81,695
"Cowen, Jared",D,01/25/1991,"Saskatoon, Saskatchewan",Canada,249,15,31,46,174
"Cowick, Bruce",F,08/18/1951,"Victoria, British Columbia",Canada,70,5,6,11,43
"Cowie, Rob",D,11/03/1967,"Toronto, Ontario",Canada,78,7,12,19,52
"Cowley, Bill",F,06/12/1912,"Bristol, Quebec",Canada,549,195,354,549,143
"Cowley, Wayne",G,12/04/1964,"Scarborough, Ontario",Canada,1,0,0,0,0
"Cox, Abby",G,07/19/1904,"London, Ontario",Canada,5,0,0,0,0
"Cox, Danny",F,10/12/1903,"Little Current, Ontario",Canada,319,48,50,98,110
"Coxe, Craig",F,01/21/1964,"Chula Vista, California",United States,235,14,31,45,713
"Coyle, Charlie",F,03/02/1992,"Weymouth, Massachusetts",United States,703,131,214,345,263
"Cozens, Dylan",F,02/09/2001,"Whitehorse, Yukon",Canada,120,17,34,51,71
"Crabb, Joseph",F,04/03/1983,"Anchorage, Alaska",United States,179,20,33,53,100
"Cracknell, Adam",F,07/15/1985,"Prince Albert, Saskatchewan",Canada,210,21,22,43,46
"Craig, Jim",G,05/31/1957,"North Easton, Massachusetts",United States,30,0,1,1,11
"Craig, Mike",F,06/06/1971,"London, Ontario",Canada,423,71,97,168,550
"Craig, Ryan",F,01/06/1982,"Abbotsford, British Columbia",Canada,198,32,31,63,148
"Craighead, John",F,11/23/1971,"Vancouver, British Columbia",Canada,5,0,0,0,10
"Craigwell, Dale",F,04/24/1971,"Toronto, Ontario",Canada,98,11,18,29,28
"Cramarossa, Joseph",F,10/26/1992,"Toronto, Ontario",Canada,64,4,8,12,77
"Crashley, Bart",D,06/15/1946,"Toronto, Ontario",Canada,140,7,36,43,50
"Craven, Murray",F,07/20/1964,"Medicine Hat, Alberta",Canada,1071,266,493,759,524
"Crawford, Bob",F,04/06/1959,"Belleville, Ontario",Canada,246,71,71,142,72
"Crawford, Bobby",F,05/27/1960,"Long Island, New York",United States,16,1,3,4,6
"Crawford, Corey",G,12/31/1984,"Montréal, Quebec",Canada,488,0,9,9,18
"Crawford, Jack",D,10/26/1916,"Dublin, Ontario",Canada,547,38,140,178,202
"Crawford, Lou",F,11/05/1962,"Belleville, Ontario",Canada,26,2,1,3,29
"Crawford, Marc",F,02/13/1961,"Belleville, Ontario",Canada,176,19,31,50,229
"Crawford, Rusty",F,11/07/1885,"Cardinal, Ontario",Canada,38,10,8,18,115
"Creighton, Adam",F,06/02/1965,"Burlington, Ontario",Canada,708,187,216,403,1077
"Creighton, Dave",F,06/24/1930,"Thunder Bay, Ontario",Canada,616,140,174,314,221
"Creighton, Jimmy",F,11/18/1905,"Brandon, Manitoba",Canada,11,1,0,1,2
"Crescenzi, Andrew",F,07/29/1992,"Thornhill, Ontario",Canada,2,0,0,0,2
"Cressman, Dave",F,01/02/1950,"Kitchener, Ontario",Canada,85,6,8,14,37
"Cressman, Glen",F,08/29/1934,"Petersburg, Ontario",Canada,4,0,0,0,2
"Crha, Jirí",G,04/13/1950,Pardubice,Czech Republic,69,0,1,1,12
"Criscuolo, Kyle",F,05/05/1992,"Southhampton Township, New Jersey",United States,15,0,2,2,6
"Crisp, Terry",F,05/28/1943,"Parry Sound, Ontario",Canada,536,67,134,201,135
"Cristofoli, Ed",F,05/14/1967,"Trail, British Columbia",Canada,9,0,1,1,4
"Croghan, Maurice",F,11/19/1914,"Montréal, Quebec",Canada,16,0,0,0,4
"Crombeen, Brandon",F,07/10/1985,"Denver, Colorado",United States,445,34,46,80,850
"Crombeen, Mike",F,04/16/1957,"Sarnia, Ontario",Canada,475,55,68,123,218
"Cronin, Shawn",D,08/20/1963,"Joliet, Illinois",United States,292,3,18,21,877
"Crosby, Sidney",F,08/07/1987,"Cole Harbour, Nova Scotia",Canada,1108,517,892,1409,731
"Cross, Cory",D,01/03/1971,"Lloydminster, Alberta",Canada,659,34,97,131,684
"Cross, Tommy",D,09/12/1989,"Simsbury, Connecticut",United States,3,0,1,1,0
"Crossett, Stanley",F,04/18/1900,"Tillsonburg, Ontario",Canada,21,0,0,0,10
"Crossman, Doug",D,06/13/1960,"Peterborough, Ontario",Canada,914,105,359,464,534
"Croteau, Gary",F,06/20/1946,"Sudbury, Ontario",Canada,684,144,175,319,143
"Crouse, Lawson",F,06/23/1997,"London, Ontario",Canada,346,56,54,110,253
"Crowder, Bruce",F,03/25/1957,"Essex, Ontario",Canada,243,47,51,98,156
"Crowder, Keith",F,01/06/1959,"Windsor, Ontario",Canada,662,223,271,494,1354
"Crowder, Troy",F,05/03/1968,"Sudbury, Ontario",Canada,150,9,7,16,433
"Crowe, Phil",F,04/14/1970,"Nanton, Alberta",Canada,94,4,5,9,173
"Crowley, Mike",D,07/04/1975,"Bloomington, Minnesota",United States,67,5,15,20,44
"Crowley, Ted",D,05/03/1970,"Concord, Massachusetts",United States,34,2,4,6,12
"Crozier, Greg",F,07/06/1976,"Calgary, Alberta",Canada,1,0,0,0,0
"Crozier, Joe",D,02/19/1929,"Winnipeg, Manitoba",Canada,5,0,3,3,2
"Crozier, Roger",G,03/16/1942,"Bracebridge, Ontario",Canada,515,0,3,3,42
"Crutchfield, Nels",F,07/12/1911,"Knowlton, Quebec",Canada,41,5,5,10,20
"Cude, Wilf",G,07/04/1910,"Barry, Wales",United Kingdom,281,0,0,0,0
"Culhane, Jim",D,03/13/1965,"Haileybury, Ontario",Canada,6,0,1,1,6
"Cullen, Barry",F,06/16/1935,"Ottawa, Ontario",Canada,218,32,52,84,103
"Cullen, Brian",F,11/11/1933,"Ottawa, Ontario",Canada,325,56,100,156,84
"Cullen, David",D,12/30/1976,"St. Catharines, Ontario",Canada,19,0,0,0,6
"Cullen, John",F,08/02/1964,"Puslinch, Ontario",Canada,621,187,363,550,898
"Cullen, Mark",F,10/28/1978,"Moorhead, Minnesota",United States,38,7,10,17,4
"Cullen, Matt",F,11/02/1976,"Virginia, Minnesota",United States,1516,266,465,731,592
"Cullen, Ray",F,09/20/1941,"Ottawa, Ontario",Canada,313,92,123,215,120
"Cullimore, Jassen",D,12/04/1972,"Simcoe, Ontario",Canada,812,26,85,111,704
"Cuma, Tyler",D,01/19/1990,"Toronto, Ontario",Canada,1,0,0,0,2
"Cumiskey, Kyle",D,12/02/1986,"Abbotsford, British Columbia",Canada,139,9,26,35,48
"Cummins, Barry",D,01/25/1949,"Regina, Saskatchewan",Canada,36,1,2,3,39
"Cummins, Jim",F,05/17/1970,"Dearborn, Michigan",United States,511,24,36,60,1538
"Cundari, Mark",D,04/23/1990,"Woodbridge, Ontario",Canada,8,1,2,3,2
"Cunneyworth, Randy",F,05/10/1961,"Etobicoke, Ontario",Canada,866,189,225,414,1282
"Cunningham, Bob",F,02/26/1941,"Welland, Ontario",Canada,4,0,1,1,0
"Cunningham, Craig",F,09/13/1990,"Trail, British Columbia",Canada,63,3,5,8,6
"Cunningham, Jim",F,08/15/1956,"St. Paul, Minnesota",United States,1,0,0,0,4
"Cunningham, Les",F,10/04/1913,"Calgary, Alberta",Canada,60,7,19,26,21
"Cupolo, Bill",F,01/08/1924,"Niagara Falls, Ontario",Canada,49,11,14,25,10
"Curran, Brian",D,11/05/1963,"Toronto, Ontario",Canada,381,7,33,40,1461
"Currie, Dan",F,03/15/1968,"Burlington, Ontario",Canada,22,2,1,3,4
"Currie, Glen",F,07/18/1958,"Montréal, Quebec",Canada,326,39,79,118,100
"Currie, Hugh",D,10/22/1925,"Saskatoon, Saskatchewan",Canada,1,0,0,0,0
"Currie, Josh",F,10/29/1992,"Charlottetown, Prince Edward Island",Canada,22,2,3,5,2
"Currie, Tony",F,11/12/1957,"Sydney Mines, Nova Scotia",Canada,290,92,119,211,73
"Curry, Floyd",F,08/11/1925,"Chapleau, Ontario",Canada,601,105,99,204,147
"Curry, John",G,02/27/1984,"Shorewood, Minnesota",United States,8,0,0,0,0
"Curtale, Tony",D,01/29/1962,"Detroit, Michigan",United States,2,0,0,0,0
"Curtis, Paul",D,09/29/1947,"Peterborough, Ontario",Canada,185,3,34,37,161
"Cushenan, Ian",D,11/29/1933,"Hamilton, Ontario",Canada,129,3,11,14,132
"Cusson, Jean",F,10/05/1942,"Verdun, Quebec",Canada,2,0,0,0,0
"Cutta, Jakub",D,12/29/1981,Jablonec nad Nisou,Czech Republic,8,0,0,0,0
"Cutts, Don",G,02/24/1953,"Edmonton, Alberta",Canada,6,0,0,0,6
"Cyr, Claude",G,03/27/1939,"Montréal, Quebec",Canada,1,0,0,0,0
"Cyr, Denis",F,02/04/1961,"Verdun, Quebec",Canada,193,41,43,84,36
"Cyr, Paul",F,10/31/1963,"Port Alberni, British Columbia",Canada,471,101,140,241,623
"Czarnik, Austin",F,12/12/1992,"Washington, Michigan",United States,142,15,30,45,20
"Czerkawski, Mariusz",F,04/13/1972,Radomsko,Poland,745,215,220,435,274
"Czuczman, Kevin",D,01/09/1991,"Port Elgin, Ontario",Canada,15,0,2,2,14
"D'Agostini, Matt",F,10/23/1986,"Sault Ste. Marie, Ontario",Canada,324,52,55,107,147
"D'Alessio, Corrie",G,09/09/1969,"Cornwall, Ontario",Canada,1,0,0,0,0
"D'Amigo, Jerry",F,02/19/1991,"Binghamton, New York",United States,31,1,2,3,2
"D'Amour, Marc",G,05/29/1961,"Sudbury, Ontario",Canada,16,0,0,0,10
"Da Costa, Stephane",F,07/11/1989,Paris,France,47,7,4,11,10
"Daccord, Joel",G,08/19/1996,"Boston, Massachusetts",United States,14,0,0,0,0
"Dach, Kirby",F,01/21/2001,"Fort Saskatchewan, Alberta",Canada,152,19,40,59,71
"Dackell, Andreas",F,12/29/1972,Gävle,Sweden,613,91,159,250,162
"Dadonov, Evgeny",F,03/12/1989,Chelyabinsk,Russia,413,124,141,265,64
"Dadswell, Doug",G,02/07/1964,"Scarborough, Ontario",Canada,27,0,2,2,2
"Dafoe, Byron",G,02/25/1971,"Sussex, England",United Kingdom,415,0,8,8,68
"Dagenais, Pierre",F,03/04/1978,"Blainville, Quebec",Canada,142,35,23,58,58
"Dahl, Kevin",D,12/30/1968,"Regina, Saskatchewan",Canada,188,7,22,29,153
"Dahlbeck, Klas",D,07/06/1991,Katrineholm,Sweden,170,6,17,23,87
"Dahlen, Jonathan",F,12/20/1997,Jönköping,Sweden,61,12,10,22,12
"Dahlen, Ulf",F,01/12/1967,Östersund,Sweden,966,301,354,655,230
"Dahlin, Kjell",F,02/02/1963,Timrå,Sweden,166,57,59,116,10
"Dahlin, Rasmus",D,04/13/2000,Trollhättan,Sweden,277,31,129,160,166
"Dahlman, Toni",F,09/03/1979,Helsinki,Finland,22,1,1,2,0
"Dahlquist, Chris",D,12/14/1962,"Fridley, Minnesota",United States,532,19,71,90,488
"Dahlström, Carl",D,01/28/1995,Stockholm,Sweden,67,0,12,12,14
"Dahlstrom, Cully",F,07/03/1912,"Minneapolis, Minnesota",United States,345,88,118,206,58
"Daigle, Alain",F,08/24/1954,"Trois-Rivières, Quebec",Canada,389,56,50,106,122
"Daigle, Alexandre",F,02/07/1975,"Montréal, Quebec",Canada,616,129,198,327,186
"Daigneault, J.J.",D,10/12/1965,"Montréal, Quebec",Canada,899,53,197,250,685
"Dailey, Bob",D,05/03/1953,"Kingston, Ontario",Canada,561,94,231,325,814
"Dal Colle, Michael",F,06/20/1996,"Woodbridge, Ontario",Canada,112,8,13,21,18
"Daley, Frank",D,08/22/1909,"Thunder Bay, Ontario",Canada,5,0,0,0,0
"Daley, Joe",G,02/20/1943,"Winnipeg, Manitoba",Canada,105,0,1,1,16
"Daley, Patrick",F,03/27/1959,Marville,France,12,1,0,1,13
"Daley, Trevor",D,10/09/1983,"Toronto, Ontario",Canada,1058,89,220,309,648
"Dalgarno, Brad",F,08/11/1967,"Vancouver, British Columbia",Canada,321,49,71,120,332
"Dallman, Kevin",D,02/26/1981,"Niagara Falls, Ontario",Canada,154,8,23,31,45
"Dallman, Marty",F,02/15/1963,"Niagara Falls, Ontario",Canada,6,0,1,1,0
"Dallman, Rod",F,01/26/1967,"Quesnel, British Columbia",Canada,6,1,0,1,26
"Dalpe, Zac",F,11/01/1989,"Paris, Ontario",Canada,154,14,14,28,36
"Dame, Napoleon",F,12/06/1913,"Edmonton, Alberta",Canada,31,2,5,7,4
"Damiani, Riley",F,03/20/2000,"Mississauga, Ontario",Canada,7,1,1,2,2
"Damore, Hank",F,07/17/1919,"Niagara Falls, Ontario",Canada,4,1,0,1,2
"Damore, Nick",G,07/10/1916,"Niagara Falls, Ontario",Canada,1,0,0,0,0
"Damphousse, Jean-Francois",G,07/21/1979,"Saint-Alexis-des-Monts, Quebec",Canada,6,0,0,0,0
"Damphousse, Vincent",F,12/17/1967,"Montréal, Quebec",Canada,1378,432,773,1205,1188
"Danault, Phillip",F,02/24/1993,"Victoriaville, Quebec",Canada,471,82,168,250,216
"Dandenault, Mathieu",D,02/03/1976,"Sherbrooke, Quebec",Canada,868,68,135,203,516
"Daneyko, Ken",D,04/17/1964,"Windsor, Ontario",Canada,1283,36,142,178,2516
"Danforth, Justin",F,03/15/1993,"Oshawa, Ontario",Canada,45,10,4,14,10
"Daniels, Jeff",F,06/24/1968,"Oshawa, Ontario",Canada,425,17,26,43,83
"Daniels, Kimbi",F,01/19/1973,"Estevan, Saskatchewan",Canada,27,1,2,3,4
"Daniels, Scott",F,09/19/1969,"Mistawasis, Saskatchewan",Canada,149,8,12,20,667
"Danis, Yann",G,06/21/1981,"Lafontaine, Quebec",Canada,55,0,0,0,0
"Dano, Marko",F,11/30/1994,Eisenstadt,Austria,141,19,26,45,49
"Dansk, Oscar",G,02/28/1994,Stockholm,Sweden,6,0,0,0,0
"Danton, Mike",F,10/21/1980,"Brampton, Ontario",Canada,87,9,5,14,182
"Daoust, Dan",F,02/29/1960,"Montréal, Quebec",Canada,522,87,167,254,544
"Darby, Craig",F,09/26/1972,"Oneida, New York",United States,196,21,35,56,32
"Darche, Mathieu",F,11/26/1976,"Montréal, Quebec",Canada,250,30,42,72,58
"Dark, Mike",D,09/17/1963,"Sarnia, Ontario",Canada,43,5,6,11,14
"Darling, Scott",G,12/22/1988,"Newport News, Virginia",United States,126,0,0,0,2
"Darragh, Harold",F,09/13/1902,"Ottawa, Ontario",Canada,307,68,49,117,44
"Darragh, Jack",F,12/04/1890,"Ottawa, Ontario",Canada,121,68,49,117,107
"Daskalakis, Cleon",G,09/29/1962,"Boston, Massachusetts",United States,12,0,0,0,0
"Datsyuk, Pavel",F,07/20/1978,Yekaterinburg,Russia,953,314,604,918,228
"Daugavins, Kaspars",F,05/18/1988,Riga,Latvia,91,6,9,15,21
"Dauphin, Laurent",F,03/27/1995,"Repentigny, Quebec",Canada,73,7,9,16,43
"David, Richard",F,04/08/1958,"Notre-Dame-de-la-Salette, Quebec",Canada,31,4,4,8,10
"Davidson, Bob",F,02/10/1912,"Toronto, Ontario",Canada,491,94,160,254,408
"Davidson, Brandon",D,08/21/1991,"Lethbridge, Alberta",Canada,180,9,14,23,82
"Davidson, Gordon",D,08/05/1918,"Stratton, Ontario",Canada,51,3,6,9,8
"Davidson, John",G,02/27/1953,"Ottawa, Ontario",Canada,301,0,7,7,60
"Davidson, Matt",F,08/09/1977,"Flin Flon, Manitoba",Canada,56,5,7,12,28
"Davidsson, Johan",F,01/06/1976,Jönköping,Sweden,83,6,9,15,16
"Davidsson, Jonathan",F,03/12/1997,Tyresö,Sweden,6,0,1,1,0
"Davie, Bob 'Pinkie'",D,09/12/1912,"Beausejour, Manitoba",Canada,41,0,1,1,25
"Davies, Jeremy",D,12/04/1996,"Montréal, Quebec",Canada,22,0,3,3,10
"Davis, Bob",F,02/02/1899,"Lachine, Quebec",Canada,3,0,0,0,0
"Davis, Kim",F,10/31/1957,"Flin Flon, Manitoba",Canada,36,5,7,12,51
"Davis, Lorne",F,07/20/1930,"Regina, Saskatchewan",Canada,95,8,12,20,20
"Davis, Mal",F,10/10/1956,"Lockeport, Nova Scotia",Canada,100,31,22,53,34
"Davis, Patrick",F,12/28/1986,"Sterling, Michigan",United States,9,1,0,1,0
"Davison, Murray",D,06/10/1938,"Brantford, Ontario",Canada,1,0,0,0,0
"Davison, Rob",D,05/01/1980,"St. Catharines, Ontario",Canada,219,3,15,18,321
"Davydov, Evgeny",F,05/27/1967,Chelyabinsk,Russia,155,40,39,79,120
"Daw, Jeff",F,02/28/1972,"Carlisle, Ontario",Canada,1,0,1,1,0
"Dawe, Jason",F,05/29/1973,"North York, Ontario",Canada,366,86,90,176,162
"Dawes, Bob",D,11/29/1924,"Saskatoon, Saskatchewan",Canada,32,2,7,9,6
"Dawes, Nigel",F,02/09/1985,"Winnipeg, Manitoba",Canada,212,39,45,84,43
"Daws, Nico",G,12/22/2000,"Burlington, Ontario",Canada,25,0,0,0,0
"Day, Hap",F,06/14/1901,"Owen Sound, Ontario",Canada,586,86,121,207,597
"Day, Joe",F,05/11/1968,"Chicago, Illinois",United States,72,1,10,11,87
"Day, Sean",D,01/09/1998,Leuven,Belgium,2,0,0,0,0
"Daze, Eric",F,07/02/1975,"Montréal, Quebec",Canada,601,226,172,398,176
"de Haan, Calvin",D,05/09/1991,"Carp, Ontario",Canada,520,19,100,119,195
"de la Rose, Jacob",F,05/20/1995,Arvika,Sweden,242,13,25,38,84
"de Leo, Chase",F,10/25/1995,"La Mirada, California",United States,7,0,0,0,0
"de Vries, Greg",D,01/04/1973,"Sundridge, Ontario",Canada,878,48,146,194,780
"Dea, Billy",F,04/03/1933,"Edmonton, Alberta",Canada,397,67,54,121,46
"Dea, Jean-Sebastien",F,02/08/1994,"La Prairie, Quebec",Canada,33,5,2,7,14
"Deacon, Don",F,06/02/1913,"Regina, Saskatchewan",Canada,27,6,4,10,6
"Deadmarsh, Adam",F,05/10/1975,"Trail, British Columbia",Canada,567,184,189,373,819
"Deadmarsh, Butch",F,04/05/1950,"Trail, British Columbia",Canada,137,12,5,17,155
"Dean, Barry",F,02/26/1955,"Maple Creek, Saskatchewan",Canada,165,25,56,81,146
"Dean, Kevin",D,04/01/1969,"Madison, Wisconsin",United States,331,7,48,55,138
"DeAngelo, Anthony",D,10/24/1995,"Sewell, New Jersey",United States,270,34,123,157,232
"Debenedet, Nelson",F,12/31/1947,Cordenons,Italy,46,10,4,14,13
"Deblois, Lucien",F,06/21/1957,"Joliette, Quebec",Canada,993,249,276,525,814
"Debol, Dave",F,03/27/1956,"Saint Claire Shores, Michigan",United States,92,26,26,52,4
"DeBrincat, Alex",F,12/18/1997,"Farmington Hills, Michigan",United States,368,160,147,307,67
"DeBrusk, Jake",F,10/17/1996,"Edmonton, Alberta",Canada,321,92,84,176,67
"Debrusk, Louie",F,03/19/1971,"Cambridge, Ontario",Canada,401,24,17,41,1161
"Decourcy, Bob",G,06/12/1927,"Toronto, Ontario",Canada,1,0,0,0,0
"Defauw, Brad",F,11/10/1977,"Edina, Minnesota",United States,9,3,0,3,2
"DeFazio, Brandon",F,09/13/1988,"Etobicoke, Ontario",Canada,2,0,0,0,0
"Defazio, Dean",F,04/16/1963,"Ottawa, Ontario",Canada,22,0,2,2,28
"Defelice, Norm",G,01/19/1933,"Timmins, Ontario",Canada,10,0,0,0,2
"Degray, Dale",D,09/03/1963,"Oshawa, Ontario",Canada,153,18,47,65,195
"DeJordy, Denis",G,11/15/1938,"Saint-Hyacinthe, Quebec",Canada,317,0,3,3,2
"Dekanich, Mark",G,05/10/1986,"North Vancouver, British Columbia",Canada,1,0,0,0,0
"DeKeyser, Danny",D,03/07/1990,"Detroit, Michigan",United States,547,33,113,146,266
"Del Zotto, Michael",D,06/24/1990,"Stouffville, Ontario",Canada,736,63,199,262,284
"Delguidice, Matt",G,03/15/1967,"West Haven, Connecticut",United States,11,0,0,0,2
"Delia, Collin",G,06/20/1994,"Rancho Cucamonga, California",United States,32,0,0,0,2
"Delisle, Jonathan",F,06/30/1977,"Sainte-Anne-des-Plaines, Quebec",Canada,1,0,0,0,0
"Delisle, Xavier",F,05/24/1977,"Québec City, Quebec",Canada,16,3,2,5,6
"Dell, Aaron",G,05/04/1989,"Airdrie, Alberta",Canada,126,0,1,1,2
"Della Rovere, Stefan",F,02/25/1990,"Richmond Hill, Ontario",Canada,7,0,0,0,11
"Dellandrea, Ty",F,07/21/2000,"Toronto, Ontario",Canada,27,3,2,5,23
"Delmonte, Armand",F,06/03/1927,"Timmins, Ontario",Canada,1,0,0,0,0
"Delmore, Andy",D,12/26/1976,"LaSalle, Ontario",Canada,283,43,58,101,105
"Delorme, Gilbert",D,11/25/1962,"Boucherville, Quebec",Canada,541,31,92,123,520
"Delorme, Ron",F,09/03/1955,"North Battleford, Saskatchewan",Canada,524,83,83,166,667
"Delory, Val",F,02/14/1927,"Toronto, Ontario",Canada,1,0,0,0,0
"Delparte, Guy",F,08/30/1949,"Sault Ste. Marie, Ontario",Canada,48,1,8,9,18
"Delvecchio, Alex",F,12/04/1932,"Thunder Bay, Ontario",Canada,1550,456,825,1281,383
"Demarco, Ab",F,05/10/1916,"North Bay, Ontario",Canada,210,72,95,167,51
"Demarco, Ab",D,02/27/1949,"Cleveland, Ohio",United States,344,44,80,124,75
"Demelo, Dylan",D,05/01/1993,"London, Ontario",Canada,397,8,78,86,179
"Demers, Jason",D,06/09/1988,"Dorval, Quebec",Canada,699,45,169,214,407
"Demers, Tony",F,07/22/1917,"Chambly, Quebec",Canada,83,20,23,43,23
"Demitra, Pavol",F,11/29/1974,Dubnica nad Váhom,Slovakia,847,304,464,768,284
"Demko, Thatcher",G,12/08/1995,"San Diego, California",United States,136,0,3,3,2
"Dempsey, Nathan",D,07/14/1974,"Spruce Grove, Alberta",Canada,260,21,67,88,120
"Denis, Jean",F,02/28/1924,"Montréal, Quebec",Canada,10,0,2,2,2
"Denis, Louis",F,06/07/1928,"Vonda, Saskatchewan",Canada,3,0,1,1,0
"Denis, Marc",G,08/01/1977,"Montréal, Quebec",Canada,349,0,6,6,32
"Denisenko, Grigory",F,06/24/2000,Novosibirsk,Russia,8,0,4,4,4
"Denneny, Corbett",F,01/25/1894,"Cornwall, Ontario",Canada,176,102,42,144,150
"Denneny, Cy",F,12/23/1891,"Farran's Point, Ontario",Canada,329,247,89,336,296
"Dennis, Norm",F,12/10/1942,"Aurora, Ontario",Canada,12,3,0,3,11
"Denoird, Gerry",F,08/04/1902,"Toronto, Ontario",Canada,1,0,0,0,0
"Depalma, Larry",F,10/27/1965,"Trenton, Michigan",United States,148,21,20,41,408
"Derlago, Bill",F,08/25/1958,"Birtle, Manitoba",Canada,555,189,227,416,247
"Dermott, Travis",D,12/22/1996,"Newmarket, Ontario",Canada,268,13,41,54,100
"Derouville, Philippe",G,08/07/1974,"Victoriaville, Quebec",Canada,3,0,0,0,0
"Desaulniers, Gerry",F,12/31/1928,"Shawinigan, Quebec",Canada,8,0,2,2,4
"Desbiens, Guillaume",F,04/20/1985,"Alma, Quebec",Canada,23,0,0,0,37
"Deschamps, Nicolas",F,01/06/1990,"LaSalle, Quebec",Canada,3,0,0,0,0
"Descoteaux, Matthieu",D,09/23/1977,"Pierreville, Quebec",Canada,5,1,1,2,4
"Desharnais, David",F,09/14/1986,"Québec City, Quebec",Canada,524,87,195,282,160
"Desilets, Joffre",F,04/16/1915,"Capreol, Ontario",Canada,192,37,45,82,57
"Desjardins, Andrew",F,07/27/1986,"Lively, Ontario",Canada,408,23,41,64,307
"Desjardins, Cedrick",G,09/30/1985,"Edmundston, New Brunswick",Canada,6,0,0,0,2
"Desjardins, Eric",D,06/14/1969,"Rouyn-Noranda, Quebec",Canada,1143,136,439,575,757
"Desjardins, Gerry",G,07/22/1944,"Sudbury, Ontario",Canada,332,0,3,3,39
"Desjardins, Martin",F,01/28/1967,"Sainte-Rose, Quebec",Canada,8,0,2,2,2
"Desjardins, Victor",F,07/04/1900,"Sault Ste. Marie, Michigan",United States,87,6,15,21,33
"Deslauriers, Jacques",D,09/03/1928,"Montréal, Quebec",Canada,2,0,0,0,0
"Deslauriers, Nick",F,02/22/1991,"LaSalle, Quebec",Canada,506,44,41,85,521
"DeSmith, Casey",G,08/13/1991,"Rochester, New Hampshire",United States,96,0,1,1,4
"Despres, Simon",D,07/27/1991,"Laval, Quebec",Canada,193,6,37,43,150
"Desrochers, Patrick",G,10/27/1979,"Penetanguishene, Ontario",Canada,11,0,0,0,2
"Deuling, Jarrett",F,03/04/1974,"Vernon, British Columbia",Canada,15,0,1,1,11
"Devane, Jamie",F,02/20/1991,"Mississauga, Ontario",Canada,2,0,0,0,0
"Deveaux, Andre",F,02/23/1984,Freeport,The Bahamas,31,0,2,2,104
"Devereaux, Boyd",F,04/16/1978,"Seaforth, Ontario",Canada,627,67,112,179,205
"Devine, Kevin",F,12/09/1954,"Toronto, Ontario",Canada,2,0,1,1,8
"Dewar, Connor",F,06/26/1999,"The Pas, Manitoba",Canada,35,2,4,6,25
"Dewar, Tom 'Moose'",D,06/10/1913,"Frobisher, Saskatchewan",Canada,9,0,2,2,4
"Dewsbury, Al",D,04/12/1926,"Goderich, Ontario",Canada,357,30,78,108,365
"Dheere, Marcel",F,12/19/1920,"St. Boniface, Manitoba",Canada,11,1,2,3,2
"Di Giuseppe, Phil",F,10/09/1993,"Toronto, Ontario",Canada,201,16,37,53,73
"Diachuk, Ed",F,08/16/1936,"Vegreville, Alberta",Canada,12,0,0,0,17
"Diaz, Raphael",D,01/09/1986,Zürich,Switzerland,201,8,41,49,62
"DiBenedetto, Justin",F,08/25/1988,"Etobicoke, Ontario",Canada,8,0,1,1,2
"Dick, Harry",D,11/22/1922,"Port Colborne, Ontario",Canada,12,0,1,1,12
"Dickens, Ernie",D,06/25/1921,"Winnipeg, Manitoba",Canada,278,12,44,56,98
"Dickenson, Herb",F,06/11/1931,"Hamilton, Ontario",Canada,48,18,17,35,10
"Dickie, Bill",G,02/20/1916,"Campbellton, New Brunswick",Canada,1,0,0,0,0
"Dickinson, Jason",F,07/04/1995,"Georgetown, Ontario",Canada,283,30,44,74,83
"DiDomenico, Chris",F,02/20/1989,"Woodbridge, Ontario",Canada,27,6,4,10,14
"Diduck, Gerald",D,04/06/1965,"Edmonton, Alberta",Canada,932,56,156,212,1612
"Dietrich, Don",D,04/05/1961,"Deloraine, Manitoba",Canada,28,0,7,7,10
"Dietz, Darren",D,07/17/1993,"Medicine Hat, Alberta",Canada,13,1,4,5,13
"Dill, Bob",D,04/25/1920,"St. Paul, Minnesota",United States,76,15,15,30,135
"Dillabough, Bob",F,04/27/1941,"Belleville, Ontario",Canada,283,32,54,86,74
"Dillon, Brenden",D,11/13/1990,"New Westminster, British Columbia",Canada,733,27,126,153,690
"Dillon, Cecil",F,04/26/1908,"Toledo, Ohio",United States,453,167,131,298,112
"Dillon, Gary",F,02/28/1959,"Toronto, Ontario",Canada,13,1,1,2,29
"Dillon, Wayne",F,05/25/1955,"Toronto, Ontario",Canada,229,43,66,109,60
"Dimaio, Rob",F,02/19/1968,"Calgary, Alberta",Canada,894,106,171,277,840
"Dimitrakos, Niko",F,05/21/1979,"Somerville, Massachusetts",United States,158,24,38,62,95
"Dineen, Bill",F,09/18/1932,"Arvida, Quebec",Canada,323,51,44,95,120
"Dineen, Cam",D,06/19/1998,"Toms River, New Jersey",United States,34,0,7,7,4
"Dineen, Gary",F,12/24/1943,"Montréal, Quebec",Canada,4,0,1,1,0
"Dineen, Gord",D,09/21/1962,"Québec City, Quebec",Canada,528,16,90,106,697
"Dineen, Kevin",F,10/28/1963,"Québec City, Quebec",Canada,1188,355,405,760,2229
"Dineen, Peter",D,11/19/1960,"Kingston, Ontario",Canada,13,0,2,2,13
"Dingman, Chris",F,07/06/1976,"Edmonton, Alberta",Canada,385,15,19,34,769
"Dinsmore, Charles",F,07/23/1903,"Toronto, Ontario",Canada,100,6,2,8,50
"Dion, Connie",G,08/11/1918,"Saint-Remi-de-Tingwick, Quebec",Canada,38,0,0,0,0
"Dion, Michel",G,02/11/1954,"Granby, Quebec",Canada,227,0,6,6,24
"Dionne, Gilbert",F,09/19/1970,"Drummondville, Quebec",Canada,223,61,79,140,108
"Dionne, Marcel",F,08/03/1951,"Drummondville, Quebec",Canada,1348,731,1040,1771,600
"DiPauli, Thomas",F,04/29/1994,Bolzano,Italy,2,0,0,0,10
"Dipenta, Joe",D,02/25/1979,"Barrie, Ontario",Canada,174,6,17,23,110
"DiPietro, Michael",G,06/09/1999,"Windsor, Ontario",Canada,3,0,0,0,0
"DiPietro, Paul",F,09/08/1970,"Sault Ste. Marie, Ontario",Canada,192,31,49,80,96
"DiPietro, Rick",G,09/19/1981,"Lewiston, Maine",United States,318,0,19,19,129
"Dirk, Robert",D,08/20/1966,"Regina, Saskatchewan",Canada,402,13,29,42,786
"Disalvatore, Jon",F,03/30/1981,"Bangor, Maine",United States,6,0,0,0,4
"Divis, Reinhard",G,07/04/1975,Vienna,Austria,28,0,0,0,2
"Divisek, Tomas",F,07/19/1979,Most,Czech Republic,5,1,0,1,0
"Djoos, Christian",D,08/06/1994,Göteborg,Sweden,155,7,31,38,28
"Djoos, Per",D,05/11/1968,Mora,Sweden,82,2,31,33,58
"Doak, Gary",D,02/25/1946,"Goderich, Ontario",Canada,790,23,107,130,908
"Doan, Shane",F,10/10/1976,"Halkirk, Alberta",Canada,1540,402,570,972,1353
"Dobbin, Brian",F,08/18/1966,"Petrolia, Ontario",Canada,63,7,8,15,61
"Dobson, Jim",F,02/29/1960,"Winnipeg, Manitoba",Canada,12,0,0,0,6
"Dobson, Noah",D,01/07/2000,"Summerside, Prince Edward Island",Canada,160,17,55,72,34
"Doell, Kevin",F,07/15/1979,"Saskatoon, Saskatchewan",Canada,8,0,1,1,4
"Doherty, Fred",F,06/15/1887,"Westwood, Ontario",Canada,2,0,0,0,0
"Doig, Jason",D,01/29/1977,"Montréal, Quebec",Canada,158,6,18,24,285
"Dollas, Bobby",D,01/31/1965,"Montréal, Quebec",Canada,646,42,96,138,467
"Dolson, Clarence",G,05/23/1897,"Hespeler, Ontario",Canada,93,0,0,0,0
"Döme, Robert",F,01/29/1979,Senica,Slovakia,53,7,7,14,12
"Domenichelli, Hnat",F,02/17/1976,"Edmonton, Alberta",Canada,267,52,61,113,104
"Domi, Max",F,03/02/1995,"Winnipeg, Manitoba",Canada,501,101,213,314,430
"Domi, Tie",F,11/01/1969,"Windsor, Ontario",Canada,1020,104,141,245,3515
"Domingue, Louis",G,03/06/1992,"Mont-Saint-Hilaire, Quebec",Canada,142,0,2,2,6
"Donaldson, Gary",D,07/15/1952,"Trail, British Columbia",Canada,1,0,0,0,0
"Donatelli, Clark",F,11/22/1965,"Providence, Rhode Island",United States,35,3,4,7,39
"Donato, Ryan",F,04/09/1996,"Scituate, Massachusetts",United States,254,51,57,108,70
"Donato, Ted",F,04/28/1969,"Boston, Massachusetts",United States,796,150,197,347,396
"Donnelly, Dave",F,02/02/1962,"Edmonton, Alberta",Canada,137,15,24,39,150
"Donnelly, Gord",F,04/05/1962,"Montréal, Quebec",Canada,554,28,41,69,2069
"Donnelly, James",D,12/22/1895,"Sault Ste. Marie, Ontario",Canada,34,0,1,1,14
"Donnelly, Mike",F,10/10/1963,"Livonia, Michigan",United States,465,114,121,235,255
"Donovan, Matt",D,05/09/1990,"Edmond, Oklahoma",United States,69,2,18,20,28
"Donovan, Shean",F,01/22/1975,"Timmins, Ontario",Canada,951,112,129,241,705
"Donskoi, Joonas",F,04/13/1992,Raahe,Finland,474,80,128,208,116
"Doornbosch, Jamie",D,02/01/1990,"Scarborough, Ontario",Canada,1,0,0,0,0
"Dopita, Jirí",F,12/02/1968,Sumperk,Czech Republic,73,12,21,33,19
"Dopson, Rob",G,08/21/1967,"Smiths Falls, Ontario",Canada,2,0,0,0,0
"Doran, John",D,05/24/1911,"Belleville, Ontario",Canada,98,5,10,15,110
"Doran, Lloyd 'Red'",F,01/10/1921,"Timmins, Ontario",Canada,24,3,2,5,10
"Doraty, Ken",F,06/23/1906,"Stittsville, Ontario",Canada,103,15,26,41,24
"Dore, Andre",D,02/11/1958,"Montréal, Quebec",Canada,257,14,81,95,261
"Dore, Daniel",F,04/09/1970,"Ferme-Neuve, Quebec",Canada,17,2,3,5,59
"Dorey, Jim",D,08/17/1947,"Kingston, Ontario",Canada,232,25,74,99,553
"Dorion, Dan",F,03/02/1963,"Astoria, New York",United States,4,1,1,2,2
"Dornhoefer, Gary",F,02/02/1943,"Kitchener, Ontario",Canada,787,214,328,542,1291
"Dorofeyev, Pavel",F,10/26/2000,Nizhny Tagil,Russia,2,0,0,0,2
"Dorohoy, Ed",F,03/13/1929,"Medicine Hat, Alberta",Canada,16,0,0,0,6
"Dorsett, Derek",F,12/20/1986,"Kindersley, Saskatchewan",Canada,515,51,76,127,1314
"Dostal, Lukas",G,06/22/2000,Brno,Czech Republic,4,0,0,0,0
"Dotchin, Jake",D,03/24/1994,"Cambridge, Ontario",Canada,103,3,20,23,112
"Doughty, Drew",D,12/08/1989,"London, Ontario",Canada,1014,132,435,567,691
"Douglas, Jordy",F,01/20/1958,"Winnipeg, Manitoba",Canada,268,76,62,138,160
"Douglas, Kent",D,02/06/1936,"Cobalt, Ontario",Canada,428,33,115,148,631
"Douglas, Les",F,12/05/1918,"Perth, Ontario",Canada,52,6,12,18,8
"Doull, Doug",F,05/31/1974,"Glace Bay, Nova Scotia",Canada,37,0,1,1,151
"Douris, Peter",F,02/19/1966,"Toronto, Ontario",Canada,321,54,67,121,80
"Dowd, Jim",F,12/25/1968,"Brick, New Jersey",United States,728,71,168,239,390
"Dowd, Nic",F,05/27/1990,"Huntsville, Alabama",United States,371,45,57,102,178
"Dowell, Jacob",F,03/04/1985,"Eau Claire, Wisconsin",United States,157,11,22,33,133
"Dowie, Bruce",G,12/09/1962,"Oakville, Ontario",Canada,2,0,0,0,0
"Dowling, Justin",F,10/01/1990,"Cochrane, Alberta",Canada,98,6,12,18,18
"Downey, Aaron",F,08/27/1974,"Shelburne, Ontario",Canada,243,8,10,18,494
"Downie, Dave",F,03/11/1909,"Burk's Falls, Ontario",Canada,11,0,0,0,2
"Downie, Steve",F,04/03/1987,"Newmarket, Ontario",Canada,434,76,120,196,1057
"Doyon, Mario",D,08/27/1968,"Québec City, Quebec",Canada,28,3,4,7,16
"Draisaitl, Leon",F,10/27/1995,Köln,Germany,558,254,362,616,206
"Drake, Dallas",F,02/04/1969,"Trail, British Columbia",Canada,1009,177,300,477,885
"Draper, Bruce",F,10/02/1940,"Toronto, Ontario",Canada,1,0,0,0,0
"Draper, Kris",F,05/24/1971,"Toronto, Ontario",Canada,1157,161,203,364,790
"Draper, Tom",G,11/20/1966,"Outremont, Quebec",Canada,53,0,3,3,4
"Drazenovic, Nicholas",F,01/14/1987,"Prince George, British Columbia",Canada,12,0,0,0,6
"Drew, Hunter",D,10/21/1998,"Kingston, Ontario",Canada,2,0,0,0,5
"Drewiske, Davis",D,11/22/1984,"Hudson, Wisconsin",United States,135,5,20,25,67
"Driedger, Chris",G,05/18/1994,"Winnipeg, Manitoba",Canada,65,0,2,2,4
"Dries, Sheldon",F,04/23/1994,"Macomb, Michigan",United States,59,5,4,9,30
"Drillon, Gordie",F,10/23/1913,"Moncton, New Brunswick",Canada,312,155,140,295,56
"Driscoll, Peter",F,10/27/1954,"Kingston, Ontario",Canada,60,3,8,11,97
"Driver, Bruce",D,04/29/1962,"Toronto, Ontario",Canada,922,96,390,486,670
"Drolet, Rene",F,11/13/1944,"Québec City, Quebec",Canada,2,0,0,0,0
"Droppa, Ivan",D,02/01/1972,Liptovsky Mikulas,Slovakia,19,0,1,1,14
"Drouillard, Clarence",F,03/02/1914,"Windsor, Ontario",Canada,10,0,1,1,0
"Drouin, Jonathan",F,03/27/1995,"Sainte-Agathe-des-Monts, Quebec",Canada,427,75,177,252,167
"Drouin, Jude",F,10/28/1948,"Mont-Louis, Quebec",Canada,666,151,305,456,346
"Drouin, P.C.",F,04/22/1974,"Saint-Lambert, Quebec",Canada,3,0,0,0,0
"Drouin, Polly",F,01/16/1916,"Verdun, Quebec",Canada,157,23,51,74,80
"Drouin-Deslauriers, Jeff",G,05/15/1984,"Saint-Jean-sur-Richelieu, Quebec",Canada,62,0,4,4,8
"Druce, John",F,02/23/1966,"Peterborough, Ontario",Canada,531,113,126,239,347
"Druken, Harold",F,01/26/1979,"St. John's, Newfoundland and Labrador",Canada,146,27,36,63,36
"Drulia, Stan",F,01/05/1968,"Elmira, New York",United States,126,15,27,42,52
"Drummond, Jim",D,10/20/1918,"Toronto, Ontario",Canada,2,0,0,0,0
"Drury, Chris",F,08/20/1976,"Trumbull, Connecticut",United States,892,255,360,615,468
"Drury, Herbert",F,03/02/1895,"Midland, Ontario",Canada,216,24,13,37,223
"Drury, Jack",F,02/03/2000,"New York, New York",United States,2,2,0,2,2
"Drury, Ted",F,09/13/1971,"Boston, Massachusetts",United States,414,41,52,93,367
"Dryden, Dave",G,09/05/1941,"Hamilton, Ontario",Canada,203,0,4,4,4
"Dryden, Ken",G,08/08/1947,"Hamilton, Ontario",Canada,397,0,19,19,12
"Drysdale, Jamie",D,04/08/2002,"Toronto, Ontario",Canada,105,7,33,40,22
"Dube, Christian",F,04/25/1977,"Sherbrooke, Quebec",Canada,33,1,1,2,4
"Dube, Dillon",F,07/20/1998,"Golden, British Columbia",Canada,200,36,39,75,50
"Dube, Gilles",F,06/02/1927,"Sherbrooke, Quebec",Canada,12,1,2,3,2
"Dube, Norm",F,09/12/1951,"Sherbrooke, Quebec",Canada,57,8,10,18,54
"Duberman, Justin",F,03/23/1970,"New Haven, Connecticut",United States,4,0,0,0,0
"Dubielewicz, Wade",G,01/30/1979,"Invermere, British Columbia",Canada,43,0,0,0,0
"Dubinsky, Brandon",F,04/29/1986,"Anchorage, Alaska",United States,823,153,285,438,905
"Dubinsky, Steve",F,07/09/1970,"Montréal, Quebec",Canada,375,25,45,70,164
"Dubnyk, Devan",G,05/04/1986,"Regina, Saskatchewan",Canada,542,0,8,8,46
"Dubois, Pierre-Luc",F,06/24/1998,"Sainte-Agathe-des-Monts, Quebec",Canada,361,102,137,239,306
"Duchene, Matt",F,01/16/1991,"Haliburton, Ontario",Canada,905,294,394,688,234
"Duchesne, Gaetan",F,07/11/1962,"Les Saules, Quebec",Canada,1028,179,254,433,617
"Duchesne, Jeremy",G,10/17/1986,"Silver Spring, Maryland",United States,1,0,0,0,0
"Duchesne, Steve",D,06/30/1965,"Sept-Îles, Quebec",Canada,1113,227,525,752,824
"Duclair, Anthony",F,08/26/1995,"Montréal, Quebec",Canada,470,120,132,252,163
"Duco, Mike",F,07/08/1987,"Toronto, Ontario",Canada,18,0,2,2,65
"Dudley, Rick",F,01/31/1949,"Toronto, Ontario",Canada,309,75,99,174,292
"Duehr, Walker",F,11/23/1997,"Sioux Falls, South Dakota",United States,1,0,0,0,0
"Duerden, Dave",F,04/11/1977,"Oshawa, Ontario",Canada,2,0,0,0,0
"Duff, Dick",F,02/18/1936,"Kirkland Lake, Ontario",Canada,1030,283,289,572,743
"Duffus, Parris",G,01/27/1970,"Denver, Colorado",United States,1,0,0,0,0
"Dufour, Luc",F,02/13/1963,"Chicoutimi, Quebec",Canada,167,23,21,44,199
"Dufour, Marc",F,09/11/1941,"Trois-Rivières, Quebec",Canada,14,1,0,1,2
"Dufresne, Donald",D,04/10/1967,"Québec City, Quebec",Canada,268,6,36,42,258
"Duggan, Jack",D,12/17/1898,"Ottawa, Ontario",Canada,27,0,0,0,0
"Duggan, Ken",D,02/21/1963,"Toronto, Ontario",Canada,1,0,0,0,0
"Duguay, Ron",F,07/06/1957,"Sudbury, Ontario",Canada,864,274,346,620,582
"Duguid, Lorne",F,04/04/1910,"Bolton, Ontario",Canada,136,9,15,24,57
"Duhaime, Brandon",F,05/22/1997,"Parkland, Florida",United States,80,6,11,17,122
"Dukowski, L.S.",D,08/30/1902,"Regina, Saskatchewan",Canada,200,16,30,46,186
"Dumart, Woody",F,12/23/1916,"Kitchener, Ontario",Canada,774,211,219,430,99
"Dumas, Michel",G,07/08/1949,"Saint-Antoine-de-Pontbriand, Quebec",Canada,8,0,1,1,0
"Dumba, Mathew",D,07/25/1994,"Regina, Saskatchewan",Canada,519,75,147,222,318
"Dumont, Gabriel",F,10/06/1990,"Dégelis, Quebec",Canada,90,4,5,9,48
"Dumont, Jean-Pierre",F,04/01/1978,"Montréal, Quebec",Canada,822,214,309,523,364
"Dumoulin, Brian",D,09/06/1991,"Biddeford, Maine",United States,464,18,96,114,130
"Dunbar, Dale",D,10/14/1961,"Winthrop, Massachusetts",United States,2,0,0,0,2
"Duncan, Arthur",D,07/04/1891,"Sault Ste. Marie, Ontario",Canada,156,18,16,34,233
"Duncan, Iain",F,08/04/1963,"Weston, Ontario",Canada,127,34,55,89,149
"Duncanson, Craig",F,03/17/1967,"Sudbury, Ontario",Canada,38,5,4,9,61
"Dundas, Rocky",F,01/30/1967,"Regina, Saskatchewan",Canada,5,0,0,0,14
"Dunham, Mike",G,06/01/1972,"Johnson City, New York",United States,394,0,5,5,16
"Dunlap, Frank",F,08/10/1924,"Ottawa, Ontario",Canada,5,0,1,1,2
"Dunlop, Blake",F,04/18/1953,"Hamilton, Ontario",Canada,550,130,274,404,172
"Dunn, Dave",D,08/19/1948,"Moosomin, Saskatchewan",Canada,184,14,41,55,313
"Dunn, Richie",D,05/12/1957,"Boston, Massachusetts",United States,483,36,140,176,314
"Dunn, Vince",D,10/29/1996,"Peterborough, Ontario",Canada,340,39,98,137,173
"Dunne, Josh",F,12/08/1998,"O'Fallon, Missouri",United States,6,0,0,0,4
"Dupere, Denis",F,06/21/1948,"Jonquière, Quebec",Canada,421,80,99,179,66
"Dupont, Andre",D,07/27/1949,"Trois-Rivières, Quebec",Canada,810,59,185,244,1986
"Dupont, Brodie",F,02/17/1987,"Russell, Manitoba",Canada,1,0,0,0,0
"Dupont, Jerry",D,02/21/1962,"Ottawa, Ontario",Canada,214,7,29,36,468
"Dupont, Micki",D,04/15/1980,"Calgary, Alberta",Canada,23,1,3,4,12
"Dupont, Norm",F,02/05/1957,"Montréal, Quebec",Canada,256,55,85,140,52
"Dupre, Yanick",F,11/20/1972,"Montréal, Quebec",Canada,35,2,0,2,16
"Dupuis, Bob",G,08/26/1952,"North Bay, Ontario",Canada,1,0,0,0,0
"Dupuis, Pascal",F,04/07/1979,"Laval, Quebec",Canada,871,190,219,409,387
"Dupuis, Philippe",F,04/24/1985,"Laval, Quebec",Canada,116,6,12,18,62
"Durbano, Steve",D,12/12/1951,"Toronto, Ontario",Canada,220,13,60,73,1127
"Duris, Vitezslav",D,01/05/1954,Plzen,Czech Republic,89,3,20,23,62
"Durnan, Bill",G,01/22/1916,"Toronto, Ontario",Canada,383,0,1,1,9
"Durno, Chris",F,10/31/1980,"Scarborough, Ontario",Canada,43,4,4,8,47
"Durzi, Sean",D,10/21/1998,"Mississauga, Ontario",Canada,64,3,24,27,55
"Dusablon, Benoit",F,08/01/1979,"Sainte-Anne-de-la-Perade, Quebec",Canada,3,0,0,0,2
"Dussault, Norm",F,09/26/1925,"Springfield, Massachusetts",United States,206,31,62,93,47
"Dutton, Mervyn 'Red'",D,07/23/1897,"Russell, Manitoba",Canada,449,28,68,96,884
"Dvorak, Christian",F,02/02/1996,"Palos, Illinois",United States,358,78,101,179,94
"Dvorák, Miroslav",D,10/11/1951,Hluboka nad Vltavou,Czech Republic,193,11,74,85,51
"Dvorák, Radek",F,03/09/1977,Tábor,Czech Republic,1260,227,363,590,449
"Dwyer, Gordie",F,01/25/1978,"Dalhousie, New Brunswick",Canada,108,0,5,5,394
"Dwyer, Mike",F,09/16/1957,"Brampton, Ontario",Canada,31,2,6,8,25
"Dwyer, Patrick",F,06/22/1983,"Spokane, Washington",United States,416,42,51,93,77
"Dyck, Ed",G,10/29/1950,"Warman, Saskatchewan",Canada,49,0,0,0,0
"Dyck, Henry",F,09/05/1912,"Herbert, Saskatchewan",Canada,1,0,0,0,0
"Dye, Cecil 'Babe'",F,05/13/1898,"Hamilton, Ontario",Canada,272,203,50,253,220
"Dykhuis, Karl",D,07/08/1972,"Sept-Îles, Quebec",Canada,644,42,91,133,495
"Dykstra, Steve",D,12/01/1962,"Edmonton, Alberta",Canada,217,8,32,40,545
"Dyte, Jack",D,10/13/1918,"New Liskeard, Ontario",Canada,27,1,0,1,31
"Dziedzic, Joe",F,12/18/1971,"Minneapolis, Minnesota",United States,130,14,14,28,131
"Dzingel, Ryan",F,03/09/1992,"Wheaton, Illinois",United States,404,87,101,188,191
"Dziurzynski, David",F,10/06/1989,"Lloydminster, Alberta",Canada,26,3,3,6,22
"Eager, Ben",F,01/22/1984,"Ottawa, Ontario",Canada,407,43,42,85,875
"Eagles, Mike",F,03/07/1963,"Sussex, New Brunswick",Canada,853,74,122,196,928
"Eakin, Bruce",F,09/28/1962,"Winnipeg, Manitoba",Canada,13,2,2,4,4
"Eakin, Cody",F,05/24/1991,"Winnipeg, Manitoba",Canada,701,110,146,256,278
"Eakins, Dallas",D,02/27/1967,"Dade City, Florida",United States,120,0,9,9,208
"Earl, Robert",F,06/02/1985,"Chicago, Illinois",United States,47,6,1,7,6
"Eastwood, Mike",F,07/01/1967,"Ottawa, Ontario",Canada,783,87,149,236,354
"Eaton, Mark",D,05/06/1977,"Wilmington, Delaware",United States,650,24,61,85,242
"Eatough, Jeff",F,06/02/1963,"Toronto, Ontario",Canada,1,0,0,0,0
"Eaves, Mike",F,06/10/1956,"Denver, Colorado",United States,324,83,143,226,80
"Eaves, Murray",F,05/10/1960,"Calgary, Alberta",Canada,57,4,13,17,9
"Eaves, Patrick",F,05/01/1984,"Calgary, Alberta",Canada,633,132,110,242,210
"Ebbett, Andrew",F,01/02/1983,"Calgary, Alberta",Canada,224,26,45,71,50
"Eberle, Jordan",F,05/15/1990,"Regina, Saskatchewan",Canada,858,262,333,595,200
"Ecclestone, Tim",F,09/24/1947,"Toronto, Ontario",Canada,692,126,233,359,344
"Eckford, Tyler",D,09/08/1985,"Vancouver, British Columbia",Canada,7,0,1,1,4
"Edberg, Rolf",F,09/29/1950,Stockholm,Sweden,184,45,58,103,24
"Eddolls, Frank",D,07/05/1921,"Lachine, Quebec",Canada,317,23,43,66,114
"Edestrand, Darryl",D,11/06/1945,"Strathroy, Ontario",Canada,455,34,90,124,404
"Edler, Alexander",D,04/21/1986,Östersund,Sweden,966,102,326,428,699
"Edmundson, Garry",F,05/06/1932,"Sexsmith, Alberta",Canada,43,4,6,10,49
"Edmundson, Joel",D,06/28/1993,"Brandon, Manitoba",Canada,416,26,65,91,380
"Edur, Tom",D,11/18/1954,"Toronto, Ontario",Canada,158,17,70,87,67
"Edwards, Don",G,09/28/1955,"Hamilton, Ontario",Canada,459,0,15,15,42
"Edwards, Gary",G,10/05/1947,"Toronto, Ontario",Canada,286,0,7,7,48
"Edwards, Marv",G,08/15/1935,"St. Catharines, Ontario",Canada,61,0,3,3,34
"Edwards, Roy",G,03/12/1937,"Seneca Township, Ontario",Canada,236,0,2,2,6
"Egan, Pat",D,04/25/1918,"Blackie, Alberta",Canada,552,77,153,230,786
"Egeland, Allan",F,01/31/1973,"Lethbridge, Alberta",Canada,17,0,0,0,16
"Egers, Jack",F,01/28/1949,"Sudbury, Ontario",Canada,284,64,69,133,154
"Ehlers, Nikolaj",F,02/14/1996,Aalborg,Denmark,478,164,194,358,165
"Ehman, Gerry",F,11/03/1932,"Cudworth, Saskatchewan",Canada,429,96,118,214,100
"Ehn, Christoffer",F,04/05/1996,Skara,Sweden,114,5,8,13,8
"Ehrhoff, Christian",D,07/06/1982,Moers,Germany,789,74,265,339,517
"Eichel, Jack",F,10/28/1996,"Chelmsford, Massachusetts",United States,409,153,227,380,152
"Eisenhut, Neil",F,02/09/1967,"Osoyoos, British Columbia",Canada,16,1,3,4,21
"Ejdsell, Victor",F,06/06/1995,Karlstad,Sweden,6,0,1,1,0
"Ekblad, Aaron",D,02/07/1996,"Belle River, Ontario",Canada,554,97,194,291,334
"Ekholm, Mattias",D,05/24/1990,Borlänge,Sweden,662,57,193,250,323
"Eklund, Brian",G,05/24/1980,"Braintree, Massachusetts",United States,1,0,0,0,0
"Eklund, Pelle",F,03/22/1963,Stockholm,Sweden,594,120,335,455,109
"Eklund, William",F,10/12/2002,Haninge,Sweden,9,0,4,4,2
"Ekman, Nils",F,03/11/1976,Stockholm,Sweden,264,60,91,151,188
"Ekman-Larsson, Oliver",D,07/17/1991,Karlskrona,Sweden,848,133,284,417,534
"Eldebrink, Anders",D,12/11/1960,Kalix,Sweden,55,3,11,14,29
"Elias, Patrik",F,04/13/1976,Trebic,Czech Republic,1240,408,617,1025,549
"Elich, Matt",F,09/22/1978,"Grosse Pointe, Michigan",United States,16,1,1,2,0
"Elie, Remi",F,04/16/1995,"Green Valley, Ontario",Canada,107,7,15,22,28
"Elik, Boris",F,10/17/1929,"Geraldton, Ontario",Canada,3,0,0,0,0
"Elik, Todd",F,04/15/1966,"Brampton, Ontario",Canada,448,110,219,329,453
"Eliot, Darren",G,11/26/1961,"Milton, Ontario",Canada,88,0,2,2,24
"Elkins, Corey",F,02/23/1985,"West Bloomfield, Michigan",United States,3,1,0,1,0
"Ellacott, Ken",G,03/03/1959,"Paris, Ontario",Canada,12,0,0,0,0
"Eller, Lars",F,05/08/1989,Rødovre,Denmark,870,153,195,348,521
"Ellerby, Keaton",D,11/05/1988,"Strathmore, Alberta",Canada,212,4,23,27,88
"Ellett, Dave",D,03/30/1964,"Cleveland, Ohio",United States,1129,153,415,568,985
"Elliott, Brian",G,04/09/1985,"Newmarket, Ontario",Canada,521,0,10,10,12
"Elliott, Fred",F,02/18/1903,"Clinton, Ontario",Canada,43,2,0,2,8
"Elliott, Stefan",D,01/30/1991,"Vancouver, British Columbia",Canada,87,8,17,25,16
"Ellis, Dan",G,06/19/1980,"Saskatoon, Saskatchewan",Canada,212,0,6,6,6
"Ellis, Matt",F,08/31/1981,"Welland, Ontario",Canada,356,21,28,49,89
"Ellis, Morgan",D,04/30/1992,"Ellerslie, Prince Edward Island",Canada,3,0,0,0,2
"Ellis, Ron",F,01/08/1945,"Lindsay, Ontario",Canada,1034,332,308,640,207
"Ellis, Ryan",D,01/03/1991,"Hamilton, Ontario",Canada,566,76,199,275,189
"Ellison, Matt",F,12/08/1983,"Duncan, British Columbia",Canada,43,3,11,14,19
"Elomo, Miika",F,04/21/1977,Turku,Finland,2,0,1,1,2
"Eloranta, Kari",D,02/29/1956,Lahti,Finland,267,13,103,116,155
"Eloranta, Mikko",F,08/24/1972,Aura,Finland,264,32,44,76,186
"Elson, Turner",F,09/13/1992,"St. Albert, Alberta",Canada,3,0,1,1,0
"Elynuik, Pat",F,10/30/1967,"Foam Lake, Saskatchewan",Canada,506,154,188,342,459
"Emelin, Alexei",D,04/25/1986,Togliatti,Russia,456,15,66,81,363
"Emerson, Nelson",F,08/17/1967,"Hamilton, Ontario",Canada,771,195,293,488,575
"Emery, Ray",G,09/28/1982,"Hamilton, Ontario",Canada,287,0,4,4,79
"Eminger, Steve",D,10/31/1983,"Woodbridge, Ontario",Canada,488,19,80,99,359
"Emma, David",F,01/14/1969,"Cranston, Rhode Island",United States,34,5,6,11,2
"Emmerton, Cory",F,06/01/1988,"St. Thomas, Ontario",Canada,139,12,9,21,22
"Emmons, Gary",F,12/30/1963,"Winnipeg, Manitoba",Canada,3,1,0,1,0
"Emmons, John",F,08/17/1974,"San Jose, California",United States,85,2,4,6,64
"Emms, Hap",F,01/12/1905,"Barrie, Ontario",Canada,330,36,53,89,324
"Endean, Craig",F,04/13/1968,"Kamloops, British Columbia",Canada,2,0,1,1,0
"Endicott, Shane",F,12/21/1981,"Saskatoon, Saskatchewan",Canada,45,1,2,3,47
"Engblom, Brian",D,01/27/1955,"Winnipeg, Manitoba",Canada,659,29,177,206,599
"Engele, Jerry",D,11/26/1950,"Humboldt, Saskatchewan",Canada,100,2,13,15,162
"Engelland, Deryk",D,04/03/1982,"Edmonton, Alberta",Canada,671,30,97,127,579
"English, John",D,05/13/1966,"Toronto, Ontario",Canada,3,1,3,4,4
"Englund, Andreas",D,01/21/1996,Stockholm,Sweden,33,0,3,3,24
"Engqvist, Andreas",F,12/23/1987,Bromma,Sweden,15,0,0,0,4
"Engvall, Pierre",F,05/31/1996,Ljungby,Sweden,168,30,32,62,52
"Ennis, Jim",D,07/10/1967,"Edmonton, Alberta",Canada,5,1,0,1,10
"Ennis, Tyler",F,10/06/1989,"Edmonton, Alberta",Canada,700,144,202,346,224
"Enroth, Jhonas",G,06/25/1988,Stockholm,Sweden,153,0,0,0,2
"Enström, Tobias",D,11/05/1984,Nordingrå,Sweden,719,54,254,308,422
"Entwistle, MacKenzie",F,07/14/1999,"Georgetown, Ontario",Canada,60,6,8,14,25
"Erat, Martin",F,08/29/1981,Trebic,Czech Republic,881,176,369,545,506
"Erickson, Autry",D,01/25/1938,"Lethbridge, Alberta",Canada,226,7,24,31,180
"Erickson, Bryan",F,03/07/1960,"Roseau, Minnesota",United States,351,80,125,205,141
"Erickson, Chad",G,08/21/1970,"Minneapolis, Minnesota",United States,2,0,0,0,0
"Erickson, Grant",F,04/28/1947,"Pierceland, Saskatchewan",Canada,6,1,0,1,0
"Ericsson, Jonathan",D,03/02/1984,Karlskrona,Sweden,680,27,98,125,535
"Eriksson, Anders",D,01/09/1975,Bollnäs,Sweden,572,22,154,176,242
"Eriksson, Joacim",G,04/09/1990,Gävle,Sweden,1,0,0,0,0
"Eriksson, Loui",F,07/17/1985,Göteborg,Sweden,1050,253,360,613,200
"Eriksson, Peter",F,07/12/1965,Kramfors,Sweden,20,3,3,6,24
"Eriksson, Roland",F,03/01/1954,Borlänge,Sweden,193,48,95,143,26
"Eriksson, Thomas",D,10/16/1959,Stockholm,Sweden,208,22,76,98,107
"Eriksson Ek, Joel",F,01/29/1997,Karlstad,Sweden,343,69,76,145,116
"Erixon, Jan",F,07/08/1962,Skellefteå,Sweden,556,57,159,216,167
"Erixon, Tim",D,02/24/1991,"Port Chester, New York",United States,93,2,12,14,38
"Erne, Adam",F,04/20/1995,"Branford, Connecticut",United States,294,32,39,71,150
"Errey, Bob",F,09/21/1964,"Montréal, Quebec",Canada,895,170,212,382,1005
"Ersberg, Erik",G,03/08/1982,Sala,Sweden,53,0,0,0,2
"Erskine, John",D,06/26/1980,"Kingston, Ontario",Canada,491,15,39,54,865
"Esau, Len",D,06/03/1968,"Meadow Lake, Saskatchewan",Canada,27,0,10,10,24
"Esche, Robert",G,01/22/1978,"Whitesboro, New York",United States,186,0,8,8,65
"Esposito, Phil",F,02/20/1942,"Sault Ste. Marie, Ontario",Canada,1282,717,873,1590,910
"Esposito, Tony",G,04/23/1943,"Sault Ste. Marie, Ontario",Canada,886,0,25,25,31
"Essensa, Bob",G,01/14/1965,"Toronto, Ontario",Canada,446,0,15,15,26
"Etem, Emerson",F,06/16/1992,"Long Beach, California",United States,173,22,24,46,30
"Evans, Chris",D,09/14/1946,"Toronto, Ontario",Canada,241,19,42,61,143
"Evans, Claude",G,04/28/1933,"Longueuil, Quebec",Canada,5,0,0,0,0
"Evans, Daryl",F,01/12/1961,"Toronto, Ontario",Canada,113,22,30,52,25
"Evans, Doug",F,06/02/1963,"Peterborough, Ontario",Canada,355,48,87,135,502
"Evans, Jack",D,04/21/1928,"Morriston, Wales",United Kingdom,754,19,80,99,990
"Evans, Jake",F,06/02/1996,"Toronto, Ontario",Canada,132,18,27,45,51
"Evans, Kevin",F,07/10/1965,"Peterborough, Ontario",Canada,9,0,1,1,44
"Evans, Paul",F,05/02/1954,"Toronto, Ontario",Canada,103,14,25,39,34
"Evans, Paul",F,02/24/1955,"Peterborough, Ontario",Canada,11,1,1,2,21
"Evans, Shawn",D,09/07/1965,"Kingston, Ontario",Canada,9,1,0,1,2
"Evans, Stewart",D,06/19/1908,"Ottawa, Ontario",Canada,367,28,49,77,427
"Evason, Dean",F,08/22/1964,"Flin Flon, Manitoba",Canada,803,139,233,372,1002
"Everberg, Dennis",F,12/31/1991,Västerås,Sweden,70,3,9,12,10
"Ewen, Todd",F,03/22/1966,"Saskatoon, Saskatchewan",Canada,518,36,40,76,1914
"Exelby, Garnet",D,08/16/1981,"Ste. Anne, Manitoba",Canada,408,7,43,50,584
"Exelby, Randy",G,08/13/1965,"Toronto, Ontario",Canada,2,0,0,0,0
"Eyssimont, Michael",F,09/09/1996,"Littleton, Colorado",United States,1,0,0,0,0
"Ezinicki, Bill",F,03/11/1924,"Winnipeg, Manitoba",Canada,368,79,105,184,707
"Fabbri, Robby",F,01/22/1996,"Mississauga, Ontario",Canada,302,73,79,152,129
"Fabbro, Dante",D,06/20/1998,"New Westminster, British Columbia",Canada,174,11,37,48,85
"Fagemo, Samuel",F,03/14/2000,Göteborg,Sweden,4,0,0,0,0
"Fahey, Brian",D,03/02/1981,"Glenview, Illinois",United States,7,0,1,1,2
"Fahey, Jim",D,05/11/1979,"Boston, Massachusetts",United States,92,1,24,25,67
"Fahey, Trevor",F,01/04/1944,"New Waterford, Nova Scotia",Canada,1,0,0,0,0
"Fairbairn, Bill",F,01/07/1947,"Brandon, Manitoba",Canada,658,162,261,423,173
"Fairchild, Cade",D,01/15/1989,"Duluth, Minnesota",United States,5,0,1,1,0
"Fairchild, Kelly",F,04/09/1973,"Hibbing, Minnesota",United States,34,2,3,5,6
"Faksa, Radek",F,01/09/1994,Opava,Czech Republic,483,71,90,161,297
"Falk, Justin",D,10/11/1988,"Snowflake, Manitoba",Canada,279,3,30,33,219
"Falkenberg, Bob",D,01/01/1946,"Stettler, Alberta",Canada,54,1,5,6,26
"Falloon, Pat",F,09/22/1972,"Foxwarren, Manitoba",Canada,575,143,179,322,141
"Fankhouser, Scott",G,07/01/1975,"Bismarck, North Dakota",United States,23,0,0,0,6
"Fantenberg, Oscar",D,10/07/1991,Ljungby,Sweden,124,5,14,19,34
"Farabee, Joel",F,02/25/2000,"Cicero, New York",United States,170,45,48,93,117
"Farkas, Jeff",F,01/24/1978,"Amherst, New York",United States,11,0,2,2,6
"Farnham, Bobby",F,01/21/1989,"North Andover, Massachusetts",United States,67,8,2,10,138
"Farr, Norm 'Rocky'",G,04/07/1947,"Toronto, Ontario",Canada,19,0,0,0,2
"Farrance, David",D,06/23/1999,"Rochester, New York",United States,2,0,0,0,0
"Farrant, Walt",F,08/12/1912,"Toronto, Ontario",Canada,1,0,0,0,0
"Farrell, Mike",D,10/20/1978,"Edina, Minnesota",United States,13,0,0,0,2
"Farrish, Dave",D,08/01/1956,"Wingham, Ontario",Canada,430,17,110,127,440
"Fasching, Hudson",F,07/28/1995,"Milwaukee, Wisconsin",United States,38,1,2,3,8
"Fashoway, Gord",F,06/16/1926,"Portage la Prairie, Manitoba",Canada,13,3,2,5,14
"Fast, Brad",D,02/21/1980,"Fort St. John, British Columbia",Canada,1,1,0,1,0
"Fast, Jesper",F,12/02/1991,Nässjö,Sweden,550,75,125,200,134
"Fasth, Viktor",G,08/08/1982,Kalix,Sweden,63,0,0,0,0
"Fata, Drew",D,07/28/1983,"Sault Ste. Marie, Ontario",Canada,8,1,1,2,9
"Fata, Rico",F,02/12/1980,"Sault Ste. Marie, Ontario",Canada,230,27,36,63,104
"Faubert, Mario",D,12/02/1954,"Salaberry-de-Valleyfield, Quebec",Canada,231,21,90,111,222
"Faulk, Justin",D,03/20/1992,"South St. Paul, Minnesota",United States,760,113,233,346,375
"Faulkner, Alex",F,05/21/1936,"Bishop's Falls, Newfoundland and Labrador",Canada,101,15,17,32,15
"Fauss, Ted",D,06/30/1961,"Clark Mills, New York",United States,28,0,2,2,15
"Faust, André",F,10/07/1969,"Joliette, Quebec",Canada,47,10,7,17,14
"Favell, Doug",G,04/05/1945,"St. Catharines, Ontario",Canada,373,0,8,8,152
"Fayne, Mark",D,05/15/1987,"Nashua, New Hampshire",United States,389,17,48,65,131
"Feamster, Dave",D,09/10/1958,"Detroit, Michigan",United States,169,13,24,37,154
"Featherstone, Glen",D,07/08/1968,"Toronto, Ontario",Canada,384,19,61,80,939
"Featherstone, Tony",F,07/31/1949,"Toronto, Ontario",Canada,130,17,21,38,65
"Federko, Bernie",F,05/12/1956,"Foam Lake, Saskatchewan",Canada,1000,369,761,1130,487
"Fedorov, Fedor",F,06/11/1981,Moscow,Russia,18,0,2,2,14
"Fedorov, Sergei",F,12/13/1969,Pskov,Russia,1248,483,696,1179,839
"Fedoruk, Todd",F,02/13/1979,"Redwater, Alberta",Canada,545,32,65,97,1050
"Fedotenko, Ruslan",F,01/18/1979,Kiev,Ukraine,863,173,193,366,472
"Fedotov, Anatoli",D,05/11/1966,Saratov,Russia,4,0,2,2,0
"Fedun, Taylor",D,06/04/1988,"Edmonton, Alberta",Canada,127,8,27,35,44
"Fedyk, Brent",F,03/08/1967,"Yorkton, Saskatchewan",Canada,470,97,112,209,308
"Fehervary, Martin",D,10/06/1999,Bratislava,Slovakia,85,8,10,18,32
"Fehr, Eric",F,09/07/1985,"Winkler, Manitoba",Canada,652,113,108,221,217
"Felix, Chris",D,05/27/1964,"Bramalea, Ontario",Canada,35,1,12,13,10
"Felsner, Brian",F,11/07/1972,"Mt. Clemens, Michigan",United States,12,1,3,4,12
"Felsner, Denny",F,04/29/1970,"Warren, Michigan",United States,18,1,4,5,6
"Feltrin, Tony",D,12/06/1961,"Ladysmith, British Columbia",Canada,48,3,3,6,65
"Fenton, Paul",F,12/22/1959,"Springfield, Massachusetts",United States,411,100,83,183,198
"Fenyves, David",D,04/29/1960,"Dunnville, Ontario",Canada,206,3,32,35,119
"Ference, Andrew",D,03/17/1979,"Edmonton, Alberta",Canada,907,43,182,225,753
"Ference, Brad",D,04/02/1979,"Calgary, Alberta",Canada,250,4,30,34,565
"Fergus, Tom",F,06/16/1962,"Chicago, Illinois",United States,726,235,346,581,499
"Ferguson, Craig",F,04/08/1970,"Castro Valley, California",United States,27,1,1,2,6
"Ferguson, Dylan",G,09/20/1998,"Lantzville, British Columbia",Canada,1,0,0,0,0
"Ferguson, George",F,08/22/1952,"Trenton, Ontario",Canada,797,160,238,398,431
"Ferguson, John",F,09/05/1938,"Vancouver, British Columbia",Canada,500,145,158,303,1216
"Ferguson, Lorne",F,05/26/1930,"Palmerston, Ontario",Canada,422,82,80,162,191
"Ferguson, Norm",F,10/16/1945,"Sydney, Nova Scotia",Canada,279,73,66,139,72
"Ferguson, Scott",D,01/06/1973,"Camrose, Alberta",Canada,218,7,14,21,310
"Ferland, Jonathan",F,02/09/1983,"Québec City, Quebec",Canada,7,1,0,1,2
"Ferland, Michael",F,04/20/1992,"Swan River, Manitoba",Canada,335,60,74,134,200
"Ferlin, Brian",F,06/03/1992,"Jacksonville, Florida",United States,7,0,1,1,0
"Fernandez, Manny",G,08/27/1974,"Etobicoke, Ontario",Canada,325,0,6,6,40
"Ferner, Mark",D,09/05/1965,"Regina, Saskatchewan",Canada,91,3,10,13,51
"Ferraro, Chris",F,01/24/1973,"Port Jefferson, New York",United States,74,7,9,16,57
"Ferraro, Landon",F,08/08/1991,"Trail, British Columbia",Canada,77,7,5,12,29
"Ferraro, Mario",D,09/17/1998,"Toronto, Ontario",Canada,180,5,37,42,68
"Ferraro, Peter",F,01/24/1973,"Port Jefferson, New York",United States,92,9,15,24,58
"Ferraro, Ray",F,08/23/1964,"Trail, British Columbia",Canada,1258,408,490,898,1288
"Ferriero, Benn",F,04/29/1987,"Boston, Massachusetts",United States,98,14,9,23,25
"Festerling, Brett",D,03/03/1986,"Prince George, British Columbia",Canada,88,0,8,8,35
"Fetisov, Vyacheslav",D,04/20/1958,Moscow,Russia,546,36,192,228,656
"Fiala, Kevin",F,07/22/1996,St. Gallen,Switzerland,419,124,159,283,217
"Fibiger, Jesse",D,04/04/1978,"Victoria, British Columbia",Canada,16,0,0,0,2
"Fichaud, Eric",G,11/04/1975,"Anjou, Quebec",Canada,95,0,1,1,4
"Fiddler, Vern",F,05/09/1980,"Edmonton, Alberta",Canada,877,104,157,261,558
"Fidler, Mike",F,08/19/1956,"Everett, Massachusetts",United States,271,84,97,181,124
"Field, Wilf",D,04/29/1915,"Winnipeg, Manitoba",Canada,220,17,25,42,149
"Fielder, Guyle",F,11/21/1930,"Potlatch, Idaho",United States,9,0,0,0,2
"Filatov, Nikita",F,05/25/1990,Moscow,Russia,53,6,8,14,20
"Filewich, Jonathan",F,10/02/1984,"Kelowna, British Columbia",Canada,5,0,0,0,0
"Filimonov, Dmitri",D,10/14/1971,Perm,Russia,30,1,4,5,18
"Fillion, Bob",F,07/12/1921,"Thetford Mines, Quebec",Canada,327,42,61,103,84
"Fillion, Marcel",F,05/28/1923,"Thetford Mines, Quebec",Canada,1,0,0,0,0
"Filmore, Tommy",F,03/14/1906,"Thamesford, Ontario",Canada,117,16,13,29,33
"Filppula, Valtteri",F,03/20/1984,Vantaa,Finland,1056,197,333,530,346
"Finger, Jeff",D,12/18/1979,"Hancock, Michigan",United States,199,17,40,57,114
"Finkbeiner, Lloyd",F,04/12/1920,"Guelph, Ontario",Canada,2,0,0,0,0
"Finley, Brian",G,07/03/1981,"Sault Ste. Marie, Ontario",Canada,4,0,0,0,0
"Finley, Jeff",D,04/14/1967,"Edmonton, Alberta",Canada,708,13,70,83,457
"Finley, Joe",F,06/29/1987,"Edina, Minnesota",United States,21,0,1,1,32
"Finn, Steven",D,08/20/1966,"Laval, Quebec",Canada,725,34,78,112,1724
"Finney, Sid",F,05/01/1929,"Banbridge, Northern Ireland",United Kingdom,59,10,7,17,4
"Finnigan, Ed",F,05/23/1913,"Shawville, Quebec",Canada,15,1,0,1,2
"Finnigan, Frank",F,07/09/1903,"Shawville, Quebec",Canada,554,116,94,210,410
"Fiore, Giovanni",F,08/13/1996,"Laval, Quebec",Canada,1,0,0,0,0
"Fiorentino, Peter",D,12/22/1968,"Niagara Falls, Ontario",Canada,1,0,0,0,0
"Fischer, Christian",F,04/15/1997,"Wayne, Illinois",United States,318,43,41,84,77
"Fischer, Jirí",D,07/31/1980,Horovice,Czech Republic,305,11,49,60,295
"Fischer, Patrick",F,09/06/1975,Zug,Switzerland,27,4,6,10,24
"Fischer, Ron",D,04/12/1959,"Merritt, British Columbia",Canada,18,0,7,7,6
"Fiset, Stephane",G,06/17/1970,"Montréal, Quebec",Canada,390,0,12,12,38
"Fisher, Alvin",F,01/05/1893,"Sault Ste. Marie, Ontario",Canada,9,1,0,1,9
"Fisher, Craig",F,06/30/1970,"Oshawa, Ontario",Canada,12,0,0,0,2
"Fisher, Dunc",F,08/30/1927,"Regina, Saskatchewan",Canada,274,45,70,115,104
"Fisher, Joe",F,07/04/1916,"Medicine Hat, Alberta",Canada,64,8,12,20,13
"Fisher, Mike",F,06/05/1980,"Peterborough, Ontario",Canada,1104,278,311,589,815
"Fistric, Mark",D,06/01/1986,"Edmonton, Alberta",Canada,325,4,30,34,284
"Fitchner, Bob",F,12/22/1950,"Sudbury, Ontario",Canada,78,12,20,32,59
"Fitzgerald, Casey",D,02/25/1997,"North Reading, Massachusetts",United States,36,0,6,6,36
"Fitzgerald, Rusty",F,10/04/1972,"Minneapolis, Minnesota",United States,25,2,2,4,12
"Fitzgerald, Tom",F,08/28/1968,"Billerica, Massachusetts",United States,1097,139,190,329,776
"Fitzgerald, Zach",D,06/16/1985,"Two Harbors, Minnesota",United States,1,0,0,0,0
"Fitzpatrick, Mark",G,11/13/1968,"Toronto, Ontario",Canada,329,0,12,12,85
"Fitzpatrick, Rory",D,01/11/1975,"Rochester, New York",United States,287,10,25,35,201
"Fitzpatrick, Ross",F,10/07/1960,"Penticton, British Columbia",Canada,20,5,2,7,0
"Fitzpatrick, Sandy",F,12/22/1944,"Paisley, Scotland",United Kingdom,22,3,6,9,8
"Fix-Wolansky, Trey",F,05/26/1999,"Edmonton, Alberta",Canada,6,1,1,2,0
"Flaherty, Wade",G,01/11/1968,"Terrace, British Columbia",Canada,120,0,3,3,6
"Flaman, Fern",D,01/25/1927,"Dysart, Saskatchewan",Canada,911,34,174,208,1372
"Flatley, Patrick",F,10/03/1963,"Toronto, Ontario",Canada,780,170,340,510,686
"Fleischmann, Tomas",F,05/16/1984,Koprivnice,Czech Republic,657,137,198,335,200
"Fleming, Gerry",D,10/16/1967,"Montréal, Quebec",Canada,11,0,0,0,42
"Fleming, Reg",F,04/21/1936,"Montréal, Quebec",Canada,749,108,132,240,1470
"Flesch, John",F,07/15/1953,"Sudbury, Ontario",Canada,124,18,23,41,117
"Fletcher, Steven",F,03/31/1962,"Montréal, Quebec",Canada,3,0,0,0,5
"Flett, Bill",F,07/21/1943,"Vermilion, Alberta",Canada,689,202,215,417,501
"Fleury, Cale",D,11/19/1998,"Carlyle, Saskatchewan",Canada,50,1,0,1,6
"Fleury, Haydn",D,07/08/1996,"Regina, Saskatchewan",Canada,215,9,22,31,45
"Fleury, Marc-Andre",G,11/28/1984,"Sorel-Tracy, Quebec",Canada,939,0,20,20,78
"Fleury, Theoren",F,06/29/1968,"Oxbow, Saskatchewan",Canada,1084,455,633,1088,1840
"Flichel, Todd",D,09/14/1964,"Osgoode, Ontario",Canada,6,0,1,1,4
"Flinn, Ryan",F,04/20/1980,"Halifax, Nova Scotia",Canada,31,1,0,1,84
"Flockhart, Rob",F,02/06/1956,"Sicamous, British Columbia",Canada,55,2,5,7,14
"Flockhart, Ron",F,10/10/1960,"Smithers, British Columbia",Canada,453,145,183,328,208
"Flood, Mark",D,09/29/1984,"Charlottetown, Prince Edward Island",Canada,39,3,5,8,10
"Florek, Justin",F,05/18/1990,"Marquette, Michigan",United States,4,1,1,2,0
"Floyd, Larry",F,05/01/1961,"Peterborough, Ontario",Canada,12,2,3,5,9
"Flynn, Brian",F,07/26/1988,"Lynnfield, Massachusetts",United States,275,27,34,61,32
"Focht, Dan",D,12/31/1977,"Regina, Saskatchewan",Canada,82,2,6,8,145
"Foegele, Warren",F,04/01/1996,"Markham, Ontario",Canada,282,47,47,94,98
"Fogarty, Bryan",D,06/11/1969,"Brantford, Ontario",Canada,156,22,52,74,119
"Fogarty, Steven",F,04/19/1993,"Edina, Minnesota",United States,29,1,2,3,12
"Fogolin, Lee",D,02/27/1926,"Thunder Bay, Ontario",Canada,427,10,47,57,570
"Fogolin, Lee",D,02/15/1955,"Chicago, Illinois",United States,924,44,194,238,1318
"Folco, Peter",D,08/13/1953,"Montréal, Quebec",Canada,2,0,0,0,0
"Foley, Gerry",F,09/22/1932,"Ware, Massachusetts",United States,142,9,14,23,95
"Foley, Rick",D,09/22/1945,"Niagara Falls, Ontario",Canada,67,11,26,37,180
"Foligno, Marcus",F,08/10/1991,"Buffalo, New York",United States,678,109,142,251,652
"Foligno, Mike",F,01/29/1959,"Sudbury, Ontario",Canada,1018,355,372,727,2047
"Foligno, Nick",F,10/31/1987,"Buffalo, New York",United States,1021,205,294,499,830
"Folin, Christian",D,02/09/1991,Kungsbacka,Sweden,244,8,36,44,120
"Folk, Bill",D,07/11/1927,"Regina, Saskatchewan",Canada,12,0,0,0,4
"Fontaine, Justin",F,11/06/1987,"Bonnyville, Alberta",Canada,197,27,41,68,58
"Fontaine, Len",F,02/25/1948,"Québec City, Quebec",Canada,46,8,11,19,10
"Fontas, Jon",F,04/16/1955,"Arlington, Massachusetts",United States,2,0,0,0,0
"Fonteyne, Val",F,12/02/1933,"Wetaskiwin, Alberta",Canada,823,75,154,229,26
"Fontinato, Lou",D,01/20/1932,"Guelph, Ontario",Canada,536,26,78,104,1248
"Foo, Spencer",F,05/19/1994,"Edmonton, Alberta",Canada,4,2,0,2,0
"Foote, Adam",D,07/10/1971,"Toronto, Ontario",Canada,1154,66,242,308,1534
"Foote, Callan",D,12/13/1998,"Englewood, Colorado",United States,91,3,9,12,58
"Foote, Nolan",F,11/29/2000,"Englewood, Colorado",United States,13,4,2,6,0
"Forbes, Colin",F,02/16/1976,"New Westminster, British Columbia",Canada,311,33,28,61,213
"Forbes, Dave",F,11/16/1948,"Montréal, Quebec",Canada,362,64,64,128,341
"Forbes, Jake",G,07/04/1897,"Toronto, Ontario",Canada,210,0,0,0,2
"Forbes, Mike",D,09/20/1957,"Brampton, Ontario",Canada,50,1,11,12,41
"Forbort, Derek",D,03/04/1992,"Duluth, Minnesota",United States,407,12,67,79,259
"Ford, Brian",G,09/22/1961,"Edmonton, Alberta",Canada,11,0,0,0,0
"Forey, Connie",F,10/18/1950,"Montréal, Quebec",Canada,4,0,0,0,2
"Formenton, Alex",F,09/13/1999,"Barrie, Ontario",Canada,109,23,16,39,71
"Forsbacka Karlsson, Jakob",F,10/31/1996,Stockholm,Sweden,29,3,6,9,2
"Forsberg, Anton",G,11/27/1992,Härnösand,Sweden,102,0,1,1,2
"Forsberg, Filip",F,08/13/1994,Östervåla,Sweden,566,220,249,469,238
"Forsberg, Peter",F,07/20/1973,Örnsköldsvik,Sweden,708,249,636,885,690
"Forsey, Jack",F,11/17/1913,"Swift Current, Saskatchewan",Canada,19,7,9,16,10
"Forsling, Gustav",D,06/12/1996,Linköping,Sweden,236,23,58,81,68
"Forslund, Gus",F,04/25/1906,Umeå,Sweden,48,4,9,13,2
"Forslund, Tomas",F,11/24/1968,Falun,Sweden,44,5,11,16,12
"Forsyth, Alex",F,01/06/1955,"Galt, Ontario",Canada,1,0,0,0,0
"Fortier, Dave",D,06/17/1951,"Sudbury, Ontario",Canada,205,8,21,29,335
"Fortier, Gabriel",F,02/06/2000,"Lachine, Quebec",Canada,10,1,0,1,4
"Fortier, Marc",F,02/26/1966,"Windsor, Quebec",Canada,212,42,60,102,135
"Fortin, Alexandre",F,02/25/1997,"Blainville, Quebec",Canada,24,3,3,6,2
"Fortin, J.F.",D,03/15/1979,"Laval, Quebec",Canada,71,1,4,5,42
"Fortin, Ray",D,03/11/1941,"Drummondville, Quebec",Canada,92,2,6,8,35
"Fortunus, Maxime",D,07/28/1983,"Longueuil, Quebec",Canada,9,0,1,1,4
"Foster, Alex",F,08/26/1984,"Canton, Michigan",United States,3,0,0,0,0
"Foster, Brian",G,02/04/1987,"Pembroke, New Hampshire",United States,1,0,0,0,0
"Foster, Corey",D,10/27/1969,"Ottawa, Ontario",Canada,45,5,6,11,24
"Foster, Dwight",F,04/02/1957,"Toronto, Ontario",Canada,541,111,163,274,420
"Foster, Harry 'Yip'",D,11/25/1907,"Guelph, Ontario",Canada,81,3,2,5,38
"Foster, Herb",F,08/09/1913,"Brockville, Ontario",Canada,6,1,0,1,0
"Foster, Kurtis",D,11/24/1981,"Carp, Ontario",Canada,405,42,118,160,308
"Foster, Norm",G,02/10/1965,"Vancouver, British Columbia",Canada,13,0,0,0,2
"Foster, Scott",G,01/17/1982,"Sarnia, Ontario",Canada,1,0,0,0,0
"Fotiu, Nick",F,05/25/1952,"Staten Island, New York",United States,646,60,77,137,1362
"Foucault, Kristopher",F,12/12/1990,"Calgary, Alberta",Canada,1,0,0,0,0
"Foudy, Liam",F,02/04/2000,"Toronto, Ontario",Canada,27,0,5,5,6
"Fountain, Mike",G,01/26/1972,"North York, Ontario",Canada,11,0,0,0,2
"Fowler, Cam",D,12/05/1991,"Windsor, Ontario",Canada,811,81,285,366,217
"Fowler, Hec",G,10/14/1892,"Saskatoon, Saskatchewan",Canada,7,0,0,0,0
"Fowler, Jimmy",D,04/06/1915,"Toronto, Ontario",Canada,135,18,29,47,39
"Fowler, Tom",F,05/18/1924,"Winnipeg, Manitoba",Canada,24,0,1,1,18
"Fox, Adam",D,02/17/1998,"Jericho, New York",United States,203,24,139,163,72
"Fox, Greg",D,08/12/1953,"Port McNeill, British Columbia",Canada,494,14,92,106,637
"Fox, Jim",F,05/18/1960,"Coniston, Ontario",Canada,578,186,293,479,143
"Foy, Matt",F,05/18/1983,"Oakville, Ontario",Canada,56,6,7,13,48
"Foyston, Frank",F,02/02/1891,"Minesing, Ontario",Canada,64,17,7,24,30
"Frampton, Bob",F,01/20/1929,"Toronto, Ontario",Canada,2,0,0,0,0
"Franceschetti, Lou",F,03/28/1958,"Toronto, Ontario",Canada,459,59,81,140,747
"Francis, Bob",F,12/05/1958,"North Battleford, Saskatchewan",Canada,14,2,0,2,0
"Francis, Emile",G,09/13/1926,"North Battleford, Saskatchewan",Canada,95,0,0,0,6
"Francis, Ron",F,03/01/1963,"Sault Ste. Marie, Ontario",Canada,1731,549,1249,1798,977
"Francouz, Pavel",G,06/03/1990,Plzen,Czech Republic,57,0,0,0,2
"Franks, Jimmy",G,11/08/1914,"Melville, Saskatchewan",Canada,42,0,0,0,0
"Franson, Cody",D,08/08/1987,"Salmon Arm, British Columbia",Canada,550,43,169,212,202
"Franzén, Johan",F,12/23/1979,Vetlanda,Sweden,602,187,183,370,401
"Fraser, Archie",F,02/09/1914,"Souris, Manitoba",Canada,3,0,1,1,0
"Fraser, Charles",F,07/22/1897,"Stellarton, Nova Scotia",Canada,1,0,0,0,0
"Fraser, Colin",F,01/28/1985,"Surrey, British Columbia",Canada,359,20,38,58,290
"Fraser, Curt",F,01/12/1958,"Cincinnati, Ohio",United States,704,193,239,432,1306
"Fraser, Gord",D,01/03/1902,"Pembroke, Ontario",Canada,144,24,12,36,235
"Fraser, Harvey",F,10/14/1918,"Souris, Manitoba",Canada,21,5,4,9,0
"Fraser, Iain",F,08/10/1969,"Scarborough, Ontario",Canada,94,23,23,46,31
"Fraser, Jamie",D,11/17/1985,"Sarnia, Ontario",Canada,1,0,0,0,0
"Fraser, Mark",D,09/29/1986,"Ottawa, Ontario",Canada,219,4,18,22,302
"Fraser, Matt",F,05/20/1990,"Red Deer, Alberta",Canada,87,11,6,17,27
"Fraser, Scott",F,05/03/1972,"Moncton, New Brunswick",Canada,71,16,15,31,24
"Frattin, Matt",F,01/03/1988,"Edmonton, Alberta",Canada,135,17,18,35,44
"Frawley, Dan",F,06/02/1962,"Sturgeon Falls, Ontario",Canada,273,37,40,77,674
"Frazee, Jeff",G,05/13/1987,"Edina, Minnesota",United States,1,0,0,0,0
"Freadrich, Kyle",F,12/28/1978,"Edmonton, Alberta",Canada,23,0,1,1,75
"Frederic, Trent",F,02/11/1998,"St. Louis, Missouri",United States,119,12,11,23,137
"Frederick, Ray",G,07/31/1929,"Fort Frances, Ontario",Canada,5,0,0,0,0
"Frederickson, Frank",F,06/03/1895,"Winnipeg, Manitoba",Canada,161,39,34,73,211
"Fredheim, Kris",D,02/23/1987,"Campbell River, British Columbia",Canada,3,0,0,0,2
"Freer, Mark",F,07/14/1968,"Toronto, Ontario",Canada,124,16,23,39,61
"Frew, Irv",D,08/16/1907,"Kilsyth, Scotland",United Kingdom,96,2,5,7,146
"Friberg, Max",F,11/20/1992,Skövde,Sweden,6,0,0,0,2
"Friday, Tim",D,03/05/1961,"Burbank, California",United States,23,0,3,3,6
"Fridgen, Dan",F,05/18/1959,"Arnprior, Ontario",Canada,13,2,3,5,2
"Friedman, Doug",F,09/01/1971,"Greenwich, Connecticut",United States,18,0,1,1,34
"Friedman, Mark",D,12/25/1995,"Toronto, Ontario",Canada,42,3,6,9,34
"Friesen, Alex",F,01/30/1991,"Niagara-on-the-Lake, Ontario",Canada,1,0,0,0,0
"Friesen, Jeff",F,08/05/1976,"Meadow Lake, Saskatchewan",Canada,893,218,298,516,488
"Friesen, Karl",G,06/30/1958,"Winnipeg, Manitoba",Canada,4,0,1,1,0
"Friest, Ron",F,11/04/1958,"Windsor, Ontario",Canada,64,7,7,14,191
"Frig, Len",D,10/30/1950,"Blairmore, Alberta",Canada,311,13,51,64,479
"Frischmon, Trevor",F,08/05/1981,"Ham Lake, Minnesota",United States,3,0,0,0,4
"Fritsch, Jamie",D,02/25/1985,"Odenton, Maryland",United States,1,0,0,0,0
"Fritsche, Dan",F,07/13/1985,"Parma, Ohio",United States,256,34,42,76,103
"Fritz, Mitchell",F,11/24/1980,"Osoyoos, British Columbia",Canada,20,0,0,0,42
"Fritz, Tanner",F,08/20/1991,"Grande Prairie, Alberta",Canada,42,3,5,8,10
"Frk, Martin",F,10/05/1993,Bochov,Czech Republic,124,20,21,41,24
"Frödén, Jesper",F,09/21/1994,Stockholm,Sweden,7,1,0,1,2
"Froese, Bob",G,06/30/1958,"St. Catharines, Ontario",Canada,242,0,10,10,90
"Froese, Byron",F,03/12/1991,"Winkler, Manitoba",Canada,116,6,11,17,49
"Frögren, Jonas",D,08/28/1980,Falun,Sweden,41,1,6,7,28
"Frolík, Michael",F,02/17/1988,Kladno,Czech Republic,858,159,225,384,317
"Frolov, Alexander",F,06/19/1982,Moscow,Russia,579,175,222,397,218
"Frost, Harry",F,08/17/1914,"Kerr Lake, Ontario",Canada,2,0,0,0,0
"Frost, Morgan",F,05/14/1999,"Aurora, Ontario",Canada,77,7,16,23,18
"Frycer, Miroslav",F,09/27/1959,Opava,Czech Republic,415,147,183,330,486
"Fryday, Bob",F,12/05/1928,"Toronto, Ontario",Canada,5,1,0,1,0
"Ftorek, Robbie",F,01/02/1952,"Needham, Massachusetts",United States,334,77,150,227,262
"Fucale, Zachary",G,05/28/1995,"Laval, Quebec",Canada,4,0,0,0,0
"Fuhr, Grant",G,09/28/1962,"Spruce Grove, Alberta",Canada,868,0,47,47,120
"Fukufuji, Yutaka",G,09/17/1982,Tokyo,Japan,4,0,0,0,0
"Fulcher, Kaden",G,09/23/1998,"Brigden, Ontario",Canada,1,0,0,0,0
"Fullan, Larry",F,08/11/1949,"Toronto, Ontario",Canada,4,1,0,1,0
"Funk, Mike",D,08/15/1986,"Abbotsford, British Columbia",Canada,9,0,2,2,0
"Fusco, Mark",D,03/12/1961,"Burlington, Massachusetts",United States,80,3,12,15,42
"Fussey, Owen",F,04/02/1983,"Winnipeg, Manitoba",Canada,4,0,1,1,0
"Gaborik, Marian",F,02/14/1982,Trencín,Slovakia,1035,407,408,815,492
"Gabriel, Kurtis",F,04/20/1993,"Newmarket, Ontario",Canada,51,2,3,5,153
"Gadjovich, Jonah",F,10/12/1998,"Whitby, Ontario",Canada,44,1,2,3,91
"Gadsby, Bill",D,08/08/1927,"Calgary, Alberta",Canada,1248,130,438,568,1539
"Gaetz, Link",D,10/02/1968,"Vancouver, British Columbia",Canada,65,6,8,14,412
"Gage, Joaquin",G,10/19/1973,"Vancouver, British Columbia",Canada,23,0,1,1,4
"Gage, Jody",F,11/29/1959,"Toronto, Ontario",Canada,68,14,15,29,26
"Gagne, Art",F,10/11/1897,"Ottawa, Ontario",Canada,228,67,34,101,259
"Gagne, Paul",F,02/06/1962,"Iroquois Falls, Ontario",Canada,390,110,101,211,127
"Gagne, Pierre",F,06/05/1940,"North Bay, Ontario",Canada,2,0,0,0,0
"Gagne, Simon",F,02/29/1980,"Québec City, Quebec",Canada,822,291,310,601,328
"Gagner, Dave",F,12/11/1964,"Chatham, Ontario",Canada,946,318,401,719,1018
"Gagner, Sam",F,08/10/1989,"London, Ontario",Canada,967,184,321,505,427
"Gagnon, Aaron",F,04/24/1986,"Quesnel, British Columbia",Canada,38,3,2,5,2
"Gagnon, Dave",G,10/31/1967,"Windsor, Ontario",Canada,2,0,0,0,0
"Gagnon, Germain",F,12/09/1942,"Chicoutimi, Quebec",Canada,259,40,101,141,72
"Gagnon, Johnny",F,06/08/1905,"Chicoutimi, Quebec",Canada,454,121,143,264,297
"Gagnon, Sean",D,09/11/1973,"Sault Ste. Marie, Ontario",Canada,12,0,1,1,34
"Gainey, Bob",F,12/13/1953,"Peterborough, Ontario",Canada,1160,239,262,501,585
"Gainey, Steve",F,01/26/1979,"Montréal, Quebec",Canada,33,0,2,2,34
"Gainor, Dutch",F,04/10/1904,"Calgary, Alberta",Canada,247,51,56,107,129
"Galanov, Maxim",D,03/13/1974,Krasnoyarsk,Russia,122,8,12,20,44
"Galarneau, Michel",F,03/01/1961,"Montréal, Quebec",Canada,78,7,10,17,34
"Galbraith, Percy",F,12/05/1898,"Toronto, Ontario",Canada,348,31,29,60,238
"Galchenyuk, Alex",F,02/12/1994,"Milwaukee, Wisconsin",United States,643,146,208,354,253
"Galiardi, T.J.",F,04/22/1988,"Calgary, Alberta",Canada,321,44,61,105,136
"Galiev, Stanislav",F,01/17/1992,Moscow,Russia,26,1,3,4,4
"Gallagher, Brendan",F,05/06/1992,"Edmonton, Alberta",Canada,638,194,187,381,397
"Gallagher, John",D,01/19/1909,"Kenora, Ontario",Canada,203,14,18,32,151
"Gallant, Brett",F,12/28/1988,"Summerside, Prince Edward Island",Canada,4,0,0,0,17
"Gallant, Gerard",F,09/02/1963,"Summerside, Prince Edward Island",Canada,615,211,269,480,1674
"Galley, Garry",D,04/16/1963,"Montréal, Quebec",Canada,1149,125,475,600,1218
"Gallimore, Jamie",F,11/28/1957,"Edmonton, Alberta",Canada,2,0,0,0,0
"Gallinger, Don",F,04/16/1925,"Port Colborne, Ontario",Canada,222,65,88,153,89
"Galvas, Jakub",D,06/15/1999,Ostrava,Czech Republic,6,0,0,0,0
"Gamache, Simon",F,01/03/1981,"Thetford Mines, Quebec",Canada,48,6,7,13,18
"Gambardella, Joe",F,12/01/1993,"Staten Island, New York",United States,15,0,3,3,2
"Gamble, Bruce",G,05/24/1938,"Thunder Bay, Ontario",Canada,328,0,1,1,24
"Gamble, Dick",F,11/16/1928,"Moncton, New Brunswick",Canada,195,41,41,82,66
"Gamble, Troy",G,04/07/1967,"New Glasgow, Nova Scotia",Canada,72,0,1,1,22
"Gambrell, Dylan",F,08/26/1996,"Bonney Lake, Washington",United States,173,13,17,30,44
"Gambucci, Gary",F,09/22/1946,"Hibbing, Minnesota",United States,51,2,7,9,9
"Ganchar, Perry",F,10/28/1963,"Saskatoon, Saskatchewan",Canada,42,3,7,10,36
"Gans, Dave",F,06/06/1964,"Brantford, Ontario",Canada,6,0,0,0,2
"Garbutt, Ryan",F,08/12/1985,"Winnipeg, Manitoba",Canada,305,39,48,87,283
"Gardiner, Bert",G,03/25/1913,"Saskatoon, Saskatchewan",Canada,144,0,1,1,0
"Gardiner, Bruce",F,02/11/1972,"Barrie, Ontario",Canada,312,34,54,88,263
"Gardiner, Chuck",G,12/31/1904,"Edinburgh, Scotland",United Kingdom,316,0,0,0,2
"Gardiner, Herb",D,05/08/1891,"Winnipeg, Manitoba",Canada,100,10,10,20,48
"Gardiner, Jake",D,07/04/1990,"Deephaven, Minnesota",United States,645,49,228,277,226
"Gardner, Bill",F,03/19/1960,"Toronto, Ontario",Canada,380,73,115,188,68
"Gardner, Cal",F,10/30/1924,"Transcona, Manitoba",Canada,696,154,238,392,517
"Gardner, Dave",F,08/23/1952,"Toronto, Ontario",Canada,350,75,115,190,41
"Gardner, George",G,10/08/1942,"Lachine, Quebec",Canada,66,0,0,0,0
"Gardner, Paul",F,03/05/1956,"Fort Erie, Ontario",Canada,447,201,201,402,207
"Gardner, Rhett",F,02/28/1996,"Moose Jaw, Saskatchewan",Canada,40,1,1,2,10
"Gare, Danny",F,05/14/1954,"Nelson, British Columbia",Canada,827,354,331,685,1285
"Gariepy, Ray",D,09/04/1928,"Toronto, Ontario",Canada,36,1,6,7,43
"Garland, Conor",F,03/11/1996,"Scituate, Massachusetts",United States,241,66,82,148,94
"Garland, Scott",F,05/16/1952,"Regina, Saskatchewan",Canada,91,13,24,37,115
"Garner, Rob",F,08/17/1958,"Weston, Ontario",Canada,1,0,0,0,0
"Garner, Tyrone",G,07/27/1978,"Stoney Creek, Ontario",Canada,3,0,0,0,0
"Garnett, Michael",G,11/25/1982,"Saskatoon, Saskatchewan",Canada,24,0,2,2,0
"Garon, Mathieu",G,01/09/1978,"Chandler, Quebec",Canada,341,0,7,7,28
"Garpenlöv, Johan",F,03/21/1968,Stockholm,Sweden,609,114,197,311,276
"Garrett, Dudley",D,07/24/1924,"Toronto, Ontario",Canada,23,1,1,2,18
"Garrett, John",G,06/17/1951,"Trenton, Ontario",Canada,207,0,6,6,41
"Garrison, Jason",D,11/13/1984,"White Rock, British Columbia",Canada,555,49,111,160,229
"Gartner, Mike",F,10/29/1959,"Ottawa, Ontario",Canada,1432,708,627,1335,1159
"Gassoff, Bob",D,04/17/1953,"Quesnel, British Columbia",Canada,245,11,47,58,866
"Gassoff, Brad",F,11/13/1955,"Quesnel, British Columbia",Canada,122,19,17,36,163
"Gatherum, Dave",G,03/28/1932,"Thunder Bay, Ontario",Canada,3,0,0,0,0
"Gatzos, Steve",F,06/22/1961,"Toronto, Ontario",Canada,89,15,20,35,83
"Gaudet, Tyler",F,04/04/1993,"Hamilton, Ontario",Canada,20,1,3,4,0
"Gaudette, Adam",F,10/03/1996,"Braintree, Massachusetts",United States,218,27,43,70,84
"Gaudreau, Frederick",F,05/01/1993,"Granby, Quebec",Canada,179,19,43,62,14
"Gaudreau, Johnny",F,08/13/1993,"Carneys Point, New Jersey",United States,602,210,399,609,132
"Gaudreau, Rob",F,01/20/1970,"Cranston, Rhode Island",United States,231,51,54,105,69
"Gaudreault, Armand",F,07/14/1921,"Lac-Saint-Jean, Quebec",Canada,45,15,9,24,27
"Gaudreault, Leo",F,10/19/1905,"Chicoutimi, Quebec",Canada,67,8,4,12,38
"Gaul, Mike",D,04/22/1973,"Lachine, Quebec",Canada,3,0,0,0,4
"Gaulin, Jean-Marc",F,03/03/1962,Balve,Germany,26,4,3,7,8
"Gaume, Dallas",F,08/27/1963,"Innisfail, Alberta",Canada,4,1,1,2,0
"Gaunce, Brendan",F,03/25/1994,"Markham, Ontario",Canada,148,11,12,23,59
"Gaunce, Cameron",D,03/19/1990,"Sudbury, Ontario",Canada,37,3,6,9,47
"Gaustad, Paul",F,02/03/1982,"Fargo, North Dakota",United States,727,89,142,231,778
"Gauthier, Art",F,10/10/1904,"Espanola, Ontario",Canada,13,0,0,0,0
"Gauthier, Daniel",F,05/17/1970,"Charlemagne, Quebec",Canada,5,0,0,0,0
"Gauthier, Denis",D,10/01/1976,"Montréal, Quebec",Canada,554,17,60,77,748
"Gauthier, Fern",F,08/31/1919,"Chicoutimi, Quebec",Canada,229,46,51,97,33
"Gauthier, Frederik",F,04/26/1995,"Laval, Quebec",Canada,178,13,18,31,47
"Gauthier, Gabe",F,01/20/1984,"Torrance, California",United States,8,0,0,0,2
"Gauthier, Jean",D,04/29/1937,"Montréal, Quebec",Canada,166,6,29,35,150
"Gauthier, Julien",F,10/15/1997,"Pointe-aux-Trembles, Quebec",Canada,96,5,13,18,30
"Gauthier, Luc",D,04/19/1964,"Longueuil, Quebec",Canada,3,0,0,0,2
"Gauthier, Paul",G,03/06/1915,"Winnipeg, Manitoba",Canada,1,0,0,0,0
"Gauthier, Sean",G,03/28/1971,"Sudbury, Ontario",Canada,1,0,0,0,0
"Gauvreau, Jocelyn",D,03/04/1964,"Masham, Quebec",Canada,2,0,0,0,0
"Gavey, Aaron",F,02/22/1974,"Sudbury, Ontario",Canada,360,41,50,91,272
"Gavin, Stewart",F,03/15/1960,"Ottawa, Ontario",Canada,768,130,155,285,584
"Gavrikov, Vladislav",D,11/21/1995,Yaroslavl,Russia,204,12,51,63,100
"Gawdin, Glenn",F,03/25/1997,"Richmond, British Columbia",Canada,9,0,1,1,2
"Gazdic, Luke",F,07/25/1989,"Toronto, Ontario",Canada,147,5,3,8,206
"Geale, Bob",F,04/17/1962,"Edmonton, Alberta",Canada,1,0,0,0,2
"Gee, George 'Hully'",F,06/28/1922,"Stratford, Ontario",Canada,551,135,183,318,347
"Geekie, Morgan",F,07/20/1998,"Strathclair, Manitoba",Canada,111,13,22,35,30
"Geertsen, Mason",D,04/19/1995,"Rocky Rapids, Alberta",Canada,25,0,0,0,77
"Geldart, Gary",D,06/14/1950,"Moncton, New Brunswick",Canada,4,0,0,0,5
"Gelinas, Eric",D,05/08/1991,"Vanier, Ontario",Canada,189,14,41,55,92
"Gelinas, Martin",F,06/05/1970,"Shawinigan, Quebec",Canada,1273,309,351,660,820
"Gelineau, Jack",G,11/11/1924,"Toronto, Ontario",Canada,143,0,0,0,4
"Gendron, Jean-Guy",F,08/30/1934,"Montréal, Quebec",Canada,864,182,201,383,695
"Gendron, Martin",F,02/15/1974,"Salaberry-de-Valleyfield, Quebec",Canada,30,4,2,6,10
"Genoway, Chay",D,12/20/1986,"Swan River, Manitoba",Canada,1,0,1,1,0
"Geoffrion, Bernie",F,02/16/1931,"Montréal, Quebec",Canada,883,393,429,822,683
"Geoffrion, Blake",F,02/03/1988,"Plantation, Florida",United States,55,8,5,13,34
"Geoffrion, Dan",F,01/24/1958,"Montréal, Quebec",Canada,111,20,32,52,99
"Georgiev, Alexandar",G,02/10/1996,Ruse,Bulgaria,129,0,4,4,2
"Geran, George",F,08/03/1896,"Braintree, Massachusetts",United States,37,5,1,6,6
"Gerard, Eddie",F,02/22/1890,"Ottawa, Ontario",Canada,128,50,51,101,126
"Gerbe, Nathan",F,07/24/1987,"Oxford, Michigan",United States,435,63,88,151,196
"Gerber, Martin",G,09/03/1974,Burgdorf,Switzerland,229,0,7,7,30
"Germain, Eric",D,06/26/1966,"Québec City, Quebec",Canada,4,0,1,1,13
"Germyn, Carsen",F,02/22/1982,"Campbell River, British Columbia",Canada,4,0,0,0,0
"Gernander, Ken",F,06/30/1969,"Coleraine, Minnesota",United States,12,2,3,5,6
"Gersich, Shane",F,07/10/1996,"Chaska, Minnesota",United States,3,0,1,1,0
"Gervais, Bruno",D,10/03/1984,"Longueuil, Quebec",Canada,418,16,71,87,182
"Getliffe, Ray",F,04/03/1914,"Galt, Ontario",Canada,397,136,137,273,280
"Gettinger, Timothy",F,04/14/1998,"North Olmsted, Ohio",United States,16,0,1,1,0
"Getzlaf, Ryan",F,05/10/1985,"Regina, Saskatchewan",Canada,1157,282,737,1019,960
"Giacomin, Ed",G,06/06/1939,"Sudbury, Ontario",Canada,610,0,9,9,68
"Giallonardo, Mario",D,09/23/1957,"Toronto, Ontario",Canada,23,0,3,3,6
"Gibbons, Brian",F,02/26/1988,"Braintree, Massachusetts",United States,204,25,42,67,58
"Gibbs, Barry",D,09/28/1948,"Lloydminster, Saskatchewan",Canada,797,58,224,282,945
"Gibson, Christopher",G,12/27/1992,Karkkila,Finland,16,0,0,0,0
"Gibson, Don",D,12/29/1967,"Deloraine, Manitoba",Canada,14,0,3,3,20
"Gibson, Doug",F,09/28/1953,"Peterborough, Ontario",Canada,63,9,19,28,0
"Gibson, John",D,06/02/1959,"St. Catharines, Ontario",Canada,48,0,2,2,120
"Gibson, John",G,07/14/1993,"Pittsburgh, Pennsylvania",United States,378,0,4,4,44
"Giesebrecht, Gus",F,09/14/1917,"Pembroke, Ontario",Canada,135,27,51,78,13
"Giffin, Lee",F,04/01/1967,"Chatham, Ontario",Canada,27,1,3,4,9
"Gignac, Brandon",F,11/07/1997,"Repentigny, Quebec",Canada,1,0,0,0,0
"Giguere, Jean-Sebastien",G,05/16/1977,"Montréal, Quebec",Canada,597,0,7,7,98
"Gilbert, Dennis",D,10/30/1996,"Williamsville, New York",United States,25,1,2,3,45
"Gilbert, Ed",F,03/12/1952,"Hamilton, Ontario",Canada,166,21,31,52,22
"Gilbert, Gilles",G,03/31/1949,"Saint-Esprit, Quebec",Canada,416,0,9,9,105
"Gilbert, Greg",F,01/22/1962,"Mississauga, Ontario",Canada,837,150,228,378,576
"Gilbert, Jeannot",F,12/29/1940,"Grand-Baie, Quebec",Canada,9,0,1,1,4
"Gilbert, Rod",F,07/01/1941,"Montréal, Quebec",Canada,1065,406,615,1021,510
"Gilbert, Tom",D,01/10/1983,"Minneapolis, Minnesota",United States,655,45,178,223,198
"Gilbertson, Stan",F,10/29/1944,"Duluth, Minnesota",United States,428,85,89,174,148
"Gilchrist, Brent",F,04/03/1967,"Moose Jaw, Saskatchewan",Canada,792,135,170,305,400
"Giles, Curt",D,11/30/1958,"The Pas, Manitoba",Canada,895,43,199,242,733
"Gilhen, Randy",F,06/13/1963,Zweibrücken,Germany,457,55,60,115,314
"Gill, Andre",G,09/19/1941,"Sorel-Tracy, Quebec",Canada,5,0,0,0,0
"Gill, Hal",D,04/06/1975,"Concord, Massachusetts",United States,1108,36,148,184,962
"Gill, Todd",D,11/09/1965,"Cardinal, Ontario",Canada,1007,82,272,354,1214
"Gillen, Don",F,12/24/1960,"Dodsland, Saskatchewan",Canada,35,2,4,6,22
"Gillies, Clark",F,04/07/1954,"Moose Jaw, Saskatchewan",Canada,958,319,378,697,1025
"Gillies, Colton",F,02/12/1989,"White Rock, British Columbia",Canada,154,6,12,18,72
"Gillies, Jon",G,01/22/1994,"Concord, New Hampshire",United States,32,0,1,1,2
"Gillies, Trevor",F,01/30/1979,"Cambridge, Ontario",Canada,57,2,1,3,261
"Gillis, Jere",F,01/18/1957,"Bend, Oregon",United States,386,78,95,173,230
"Gillis, Mike",F,12/01/1958,"Sudbury, Ontario",Canada,246,33,43,76,186
"Gillis, Paul",F,12/31/1963,"Toronto, Ontario",Canada,624,88,154,242,1501
"Gilmour, Doug",F,06/25/1963,"Kingston, Ontario",Canada,1474,450,964,1414,1301
"Gilmour, John",D,05/17/1993,"Montréal, Quebec",Canada,37,2,3,5,18
"Gilroy, Matt",D,07/20/1984,"North Bellmore, New York",United States,225,11,37,48,67
"Gingras, Gaston",D,02/13/1959,"Temiscaming, Quebec",Canada,476,61,174,235,161
"Gionta, Brian",F,01/18/1979,"Rochester, New York",United States,1026,291,304,595,377
"Gionta, Stephen",F,10/09/1983,"Rochester, New York",United States,301,16,40,56,95
"Giordano, Mark",D,10/03/1983,"Toronto, Ontario",Canada,1024,151,393,544,816
"Girard, Bob",F,04/12/1949,"Montréal, Quebec",Canada,305,45,69,114,140
"Girard, Jonathan",D,05/27/1980,"Rawdon, Quebec",Canada,150,10,34,44,46
"Girard, Ken",F,12/08/1936,"Toronto, Ontario",Canada,7,0,1,1,2
"Girard, Samuel",D,05/12/1998,"Roberval, Quebec",Canada,340,22,122,144,67
"Girardi, Daniel",D,04/29/1984,"Welland, Ontario",Canada,927,56,208,264,314
"Girgensons, Zemgus",F,01/05/1994,Riga,Latvia,545,71,85,156,157
"Giroux, Alexandre",F,06/16/1981,"Québec City, Quebec",Canada,48,6,6,12,26
"Giroux, Art",F,06/06/1908,"Winnipeg, Manitoba",Canada,54,6,4,10,14
"Giroux, Claude",F,01/12/1988,"Hearst, Ontario",Canada,1018,294,629,923,418
"Giroux, Larry",D,08/28/1951,"Weyburn, Saskatchewan",Canada,274,15,74,89,333
"Giroux, Pierre",F,11/17/1955,"Hawkesbury, Ontario",Canada,6,1,0,1,17
"Giroux, Ray",D,07/20/1976,"North Bay, Ontario",Canada,38,0,13,13,22
"Giuliano, Jeff",F,06/20/1979,"Nashua, New Hampshire",United States,101,3,10,13,40
"Gladney, Bob",D,08/27/1957,"Come By Chance, Newfoundland and Labrador",Canada,14,1,5,6,4
"Gladu, Paul",F,06/20/1921,"Saint-Hyacinthe, Quebec",Canada,40,6,14,20,2
"Glass, Cody",F,04/01/1999,"Winnipeg, Manitoba",Canada,74,9,14,23,14
"Glass, Jeff",G,11/19/1985,"Calgary, Alberta",Canada,15,0,0,0,2
"Glass, Tanner",F,11/29/1983,"Regina, Saskatchewan",Canada,527,24,45,69,658
"Gleason, Benjamin",D,03/25/1998,"Ortonville, Michigan",United States,4,0,1,1,0
"Gleason, Tim",D,01/29/1983,"Clawson, Michigan",United States,727,17,125,142,701
"Glencross, Curtis",F,12/28/1982,"Kindersley, Saskatchewan",Canada,507,134,141,275,351
"Glendening, Luke",F,04/28/1989,"Grand Rapids, Michigan",United States,636,66,76,142,209
"Glennie, Brian",D,08/29/1946,"Toronto, Ontario",Canada,572,14,100,114,621
"Glennie, Scott",F,02/22/1991,"Winnipeg, Manitoba",Canada,1,0,0,0,2
"Glennon, Matthew",F,09/20/1968,"Hull, Massachusetts",United States,3,0,0,0,2
"Globke, Rob",F,10/24/1982,"Farmington, Michigan",United States,46,1,1,2,8
"Gloeckner, Lorry",D,01/25/1956,"Kindersley, Saskatchewan",Canada,13,0,2,2,6
"Gloor, Danny",F,12/04/1952,"Stratford, Ontario",Canada,2,0,0,0,0
"Glover, Fred",F,01/05/1928,"Toronto, Ontario",Canada,92,13,11,24,62
"Glover, Howie",F,02/14/1935,"Toronto, Ontario",Canada,144,29,17,46,101
"Glumac, Mike",F,04/05/1980,"Niagara Falls, Ontario",Canada,40,7,6,13,38
"Glynn, Brian",D,11/23/1967,Iserlohn,Germany,431,25,79,104,410
"Goc, Marcel",F,08/24/1983,Calw,Germany,636,75,113,188,157
"Goc, Sascha",D,04/14/1979,Calw,Germany,22,0,0,0,4
"Godard, Eric",F,03/07/1980,"Vernon, British Columbia",Canada,335,6,12,18,833
"Godden, Ernie",F,03/13/1961,"Keswick, Ontario",Canada,5,1,1,2,6
"Godfrey, Warren",D,03/23/1931,"Toronto, Ontario",Canada,789,32,125,157,754
"Godin, Eddy",F,03/29/1957,"Donnacona, Quebec",Canada,27,3,6,9,12
"Godin, Sammy",F,09/20/1909,"Rockland, Ontario",Canada,79,4,3,7,34
"Godynyuk, Alexander",D,01/27/1970,Kiev,Ukraine,223,10,39,49,224
"Goegan, Pete",D,03/06/1934,"Thunder Bay, Ontario",Canada,383,19,67,86,365
"Goertz, Dave",D,03/28/1965,"Edmonton, Alberta",Canada,2,0,0,0,2
"Goertzen, Steven",F,05/26/1984,"Stony Plain, Alberta",Canada,68,2,2,4,83
"Goldham, Bob",D,05/12/1922,"Georgetown, Ontario",Canada,650,28,143,171,402
"Goldmann, Erich",D,04/07/1976,Dingolfing,Germany,1,0,0,0,0
"Goldobin, Nikolai",F,10/07/1995,Moscow,Russia,125,19,27,46,24
"Goldsworthy, Bill",F,08/24/1944,"Waterloo, Ontario",Canada,771,283,258,541,796
"Goldsworthy, Leroy",F,10/18/1906,"Two Harbors, Minnesota",United States,336,66,57,123,81
"Goldup, Glenn",F,04/26/1953,"St. Catharines, Ontario",Canada,291,52,67,119,303
"Goldup, Hank",F,10/29/1918,"Kingston, Ontario",Canada,202,63,80,143,97
"Goligoski, Alex",D,07/30/1985,"Grand Rapids, Minnesota",United States,996,85,374,459,342
"Goloubef, Cody",D,11/30/1989,"Mississauga, Ontario",Canada,160,3,22,25,76
"Golubovsky, Yan",D,03/09/1976,Novosibirsk,Russia,56,1,7,8,32
"Gomez, Scott",F,12/23/1979,"Anchorage, Alaska",United States,1079,181,575,756,655
"Gonchar, Sergei",D,04/13/1974,Chelyabinsk,Russia,1301,220,591,811,981
"Goneau, Daniel",F,01/16/1976,"Montréal, Quebec",Canada,53,12,3,15,14
"Gooden, Billy",F,09/08/1923,"Winnipeg, Manitoba",Canada,53,9,12,21,15
"Goodenough, Larry",D,01/19/1953,"Toronto, Ontario",Canada,242,22,77,99,179
"Goodfellow, Ebbie",F,04/09/1907,"Ottawa, Ontario",Canada,557,135,191,326,511
"Goodman, Paul",G,05/25/1905,"Selkirk, Manitoba",Canada,52,0,0,0,0
"Goodrow, Barclay",F,02/26/1993,"Toronto, Ontario",Canada,410,45,81,126,373
"Gordiouk, Viktor",F,04/11/1970,Odintsovo,Russia,26,3,8,11,0
"Gordon, Andrew",F,12/13/1985,"Halifax, Nova Scotia",Canada,55,3,4,7,6
"Gordon, Boyd",F,10/19/1983,"Unity, Saskatchewan",Canada,706,56,105,161,149
"Gordon, Fred",F,05/06/1900,"Fleming, Saskatchewan",Canada,81,8,7,15,70
"Gordon, Jack",F,03/03/1928,"Winnipeg, Manitoba",Canada,36,3,10,13,0
"Gordon, Robb",F,01/13/1976,"Murrayville, British Columbia",Canada,4,0,0,0,2
"Gordon, Scott",G,02/06/1963,"Brockton, Massachusetts",United States,23,0,0,0,0
"Goren, Lee",F,12/26/1977,"Winnipeg, Manitoba",Canada,67,5,4,9,44
"Gorence, Tom",F,03/11/1957,"St. Paul, Minnesota",United States,303,58,53,111,89
"Gorges, Josh",D,08/14/1984,"Kelowna, British Columbia",Canada,783,17,107,124,404
"Goring, Butch",F,10/22/1949,"St. Boniface, Manitoba",Canada,1107,375,513,888,102
"Gorman, Dave",F,04/08/1955,"Oshawa, Ontario",Canada,3,0,0,0,0
"Gorman, Edwin",D,09/25/1892,"Buckingham, Quebec",Canada,111,14,6,20,110
"Gormley, Brandon",D,02/18/1992,"Murray River, Prince Edward Island",Canada,58,2,3,5,20
"Gosselin, Ben",F,07/19/1957,"Montréal, Quebec",Canada,7,0,0,0,33
"Gosselin, David",F,06/22/1977,"Lévis, Quebec",Canada,13,2,1,3,11
"Gosselin, Guy",D,01/06/1964,"Rochester, Minnesota",United States,5,0,0,0,6
"Gosselin, Mario",G,06/15/1963,"Thetford Mines, Quebec",Canada,241,0,9,9,42
"Gostisbehere, Shayne",D,04/20/1993,"Margate, Florida",United States,463,74,196,270,155
"Gotaas, Steve",F,05/10/1967,"Camrose, Alberta",Canada,49,6,9,15,53
"Gottselig, Johnny",F,06/24/1906,Klosterdorf,Ukraine,591,176,196,372,211
"Goulbourne, Tyrell",F,01/26/1994,"Edmonton, Alberta",Canada,11,0,0,0,2
"Gould, Bob",F,09/02/1957,"Petrolia, Ontario",Canada,697,145,159,304,572
"Gould, John",F,04/11/1949,"Beeton, Ontario",Canada,504,131,138,269,113
"Gould, Larry",F,08/16/1952,"Alliston, Ontario",Canada,2,0,0,0,0
"Goulet, Michel",F,04/21/1960,"Peribonka, Quebec",Canada,1089,548,605,1153,825
"Goupille, Cliff",D,09/02/1915,"Trois-Rivières, Quebec",Canada,224,12,28,40,256
"Gourde, Yanni",F,12/15/1991,"Saint-Narcisse, Quebec",Canada,384,101,134,235,264
"Gove, David",F,05/04/1978,"Centerville, Massachusetts",United States,2,0,1,1,0
"Govedaris, Chris",F,02/02/1970,"Toronto, Ontario",Canada,45,4,6,10,24
"Goverde, David",G,04/09/1970,"Toronto, Ontario",Canada,5,0,1,1,0
"Goyer, Gerry",F,10/20/1936,"Belleville, Ontario",Canada,40,1,2,3,4
"Goyette, Phil",F,10/31/1933,"Lachine, Quebec",Canada,940,207,467,674,123
"Grabner, Michael",F,10/05/1987,Villach,Austria,640,175,101,276,110
"Graborenko, Roman",D,08/24/1992,Mogilev,Belarus,1,0,0,0,0
"Graboski, Tony",F,05/09/1916,"Timmins, Ontario",Canada,66,6,10,16,24
"Grabovski, Mikhail",F,01/31/1984,Potsdam,Germany,534,125,171,296,312
"Grachev, Evgeny",F,02/21/1990,Khabarovsk,Russia,34,1,3,4,2
"Gracie, Bob",F,11/08/1910,"North Bay, Ontario",Canada,380,82,110,192,203
"Gradin, Thomas",F,02/18/1956,Sollefteå,Sweden,677,209,384,593,298
"Gragnani, Marc-Andre",D,03/11/1987,"Montréal, Quebec",Canada,78,3,15,18,36
"Graham, Dirk",F,07/29/1959,"Regina, Saskatchewan",Canada,772,219,270,489,919
"Graham, Leth",F,10/10/1894,"Ottawa, Ontario",Canada,26,3,0,3,0
"Graham, Pat",F,05/25/1961,"Toronto, Ontario",Canada,103,11,17,28,136
"Graham, Rod",F,08/19/1946,"London, Ontario",Canada,14,2,1,3,7
"Graham, Ted",D,01/30/1906,"Owen Sound, Ontario",Canada,347,14,26,40,301
"Grahame, John",G,08/31/1975,"Denver, Colorado",United States,224,0,9,9,51
"Grahame, Ron",G,06/07/1950,"Victoria, British Columbia",Canada,114,0,3,3,10
"Granato, Tony",F,07/25/1964,"Downers Grove, Illinois",United States,773,248,244,492,1425
"Granberg, Petter",D,08/27/1992,Skellefteå,Sweden,45,0,2,2,29
"Grand-Pierre, Jean-Luc",D,02/02/1977,"Montréal, Quebec",Canada,269,7,13,20,311
"Granlund, Markus",F,04/16/1993,Oulu,Finland,335,58,43,101,86
"Granlund, Mikael",F,02/26/1992,Oulu,Finland,671,135,308,443,197
"Grant, Alex",D,01/20/1989,"Antigonish, Nova Scotia",Canada,7,2,0,2,9
"Grant, Benny",G,07/14/1908,"Owen Sound, Ontario",Canada,53,0,0,0,0
"Grant, Danny",F,02/21/1946,"Fredericton, New Brunswick",Canada,736,263,273,536,239
"Grant, Derek",F,04/20/1990,"Abbotsford, British Columbia",Canada,381,52,62,114,137
"Grant, Doug",G,07/27/1948,"Corner Brook, Newfoundland and Labrador",Canada,77,0,0,0,2
"Grant, Triston",F,02/02/1984,"Neepawa, Manitoba",Canada,11,0,1,1,19
"Graovac, Tyler",F,04/27/1993,"Brampton, Ontario",Canada,84,12,3,15,20
"Gratton, Benoit",F,12/28/1976,"Montréal, Quebec",Canada,58,6,10,16,58
"Gratton, Chris",F,07/05/1975,"Brantford, Ontario",Canada,1092,214,354,568,1638
"Gratton, Dan",F,12/07/1966,"Brantford, Ontario",Canada,7,1,0,1,5
"Gratton, Gilles",G,07/28/1952,"LaSalle, Quebec",Canada,47,0,0,0,15
"Gratton, Josh",F,09/09/1982,"Brantford, Ontario",Canada,86,3,3,6,294
"Gratton, Norm",F,12/22/1950,"LaSalle, Quebec",Canada,201,39,45,84,64
"Gravel, Kevin",D,03/06/1992,"Kingsford, Michigan",United States,109,1,12,13,12
"Gravelle, Leo",F,06/10/1925,"Aylmer, Quebec",Canada,223,44,34,78,38
"Graves, Adam",F,04/12/1968,"Tecumseh, Ontario",Canada,1152,329,287,616,1224
"Graves, Hilliard",F,10/18/1950,"Saint John, New Brunswick",Canada,556,118,163,281,209
"Graves, Ryan",D,05/21/1995,"Yarmouth, Nova Scotia",Canada,224,20,54,74,126
"Graves, Steve",F,04/07/1964,"Trenton, Ontario",Canada,35,5,4,9,10
"Gray, Alex",F,06/21/1899,"Glasgow, Scotland",United Kingdom,50,7,1,8,30
"Gray, Gerry",G,01/28/1948,"Brantford, Ontario",Canada,8,0,0,0,0
"Gray, Harrison",G,09/05/1941,"Calgary, Alberta",Canada,1,0,0,0,0
"Gray, Terry",F,03/21/1938,"Montréal, Quebec",Canada,147,26,28,54,62
"Grebeshkov, Denis",D,10/11/1983,Yaroslavl,Russia,234,17,68,85,114
"Greco, Anthony",F,09/30/1993,"New York, New York",United States,2,0,0,0,0
"Green, Josh",F,11/16/1977,"Camrose, Alberta",Canada,341,36,40,76,206
"Green, Mike",F,10/12/1979,"Calgary, Alberta",Canada,24,1,3,4,4
"Green, Mike",D,10/12/1985,"Calgary, Alberta",Canada,880,150,351,501,592
"Green, Red",F,12/12/1899,"Sudbury, Ontario",Canada,195,60,27,87,277
"Green, Rick",D,02/20/1956,"Belleville, Ontario",Canada,845,43,220,263,588
"Green, Shorty",F,07/17/1896,"Sudbury, Ontario",Canada,103,34,22,56,167
"Green, Ted",D,03/23/1940,"Eriksdale, Manitoba",Canada,621,48,206,254,1029
"Green, Travis",F,12/20/1970,"Castlegar, British Columbia",Canada,970,193,262,455,764
"Greene, Andy",D,10/30/1982,"Trenton, Michigan",United States,1057,52,212,264,277
"Greene, Matt",D,05/13/1983,"Grand Ledge, Michigan",United States,615,17,63,80,663
"Greening, Colin",F,03/09/1986,"St. John's, Newfoundland and Labrador",Canada,286,45,57,102,150
"Greenlaw, Jeff",F,02/28/1968,"Toronto, Ontario",Canada,57,3,6,9,108
"Greenlay, Mike",G,09/15/1968,Vitoria,Brazil,2,0,1,1,0
"Greentree, Kyle",F,11/15/1983,"Victoria, British Columbia",Canada,4,0,0,0,0
"Greenway, Jordan",F,02/16/1997,"Potsdam, New York",United States,272,36,76,112,201
"Greer, A.J.",F,12/14/1996,"Joliette, Quebec",Canada,47,2,6,8,56
"Gregg, Randy",D,02/19/1956,"Edmonton, Alberta",Canada,474,41,152,193,333
"Gregor, Noah",F,01/28/1998,"Edmonton, Alberta",Canada,121,16,18,34,39
"Greig, Bruce",F,05/09/1953,"High River, Alberta",Canada,9,0,1,1,46
"Greig, Mark",F,01/25/1970,"High River, Alberta",Canada,125,13,27,40,90
"Greiss, Thomas",G,01/29/1986,Füssen,Germany,347,0,4,4,16
"Grenier, Alexandre",F,09/05/1991,"Laval, Quebec",Canada,9,0,0,0,2
"Grenier, Lucien",F,11/03/1946,"Malartic, Quebec",Canada,152,14,14,28,18
"Grenier, Martin",D,11/02/1980,"Laval, Quebec",Canada,18,1,0,1,14
"Grenier, Richard",F,09/18/1952,"Montréal, Quebec",Canada,10,1,1,2,2
"Greschner, Ron",D,12/22/1954,"Goodsoil, Saskatchewan",Canada,981,179,431,610,1226
"Gretzky, Brent",F,02/20/1972,"Brantford, Ontario",Canada,13,1,3,4,2
"Gretzky, Wayne",F,01/26/1961,"Brantford, Ontario",Canada,1487,894,1963,2857,577
"Grier, Mike",F,01/05/1975,"Detroit, Michigan",United States,1060,162,221,383,510
"Grieve, Brent",F,05/09/1969,"Oshawa, Ontario",Canada,97,20,16,36,87
"Griffith, Seth",F,01/04/1993,"Wallaceburg, Ontario",Canada,80,8,11,19,24
"Grigor, George",F,09/03/1916,"Edinburgh, Scotland",United Kingdom,2,1,0,1,0
"Grigorenko, Mikhail",F,05/16/1994,Khabarovsk,Russia,249,26,50,76,36
"Grimaldi, Rocco",F,02/08/1993,"Rossmoor, California",United States,203,30,37,67,34
"Grimson, Stu",F,05/20/1965,"Kamloops, British Columbia",Canada,729,17,22,39,2113
"Grisdale, John",D,08/23/1948,"Geraldton, Ontario",Canada,250,4,39,43,346
"Groleau, Francois",D,01/23/1973,"Longueuil, Quebec",Canada,8,0,1,1,6
"Gron, Stanislav",F,10/28/1978,Bratislava,Slovakia,1,0,0,0,0
"Grönman, Tuomas",D,03/22/1974,Viitasaari,Finland,38,1,3,4,38
"Gronsdahl, Lloyd",F,05/10/1921,"Norquay, Saskatchewan",Canada,10,1,2,3,0
"Grönstrand, Jari",D,11/14/1962,Tampere,Finland,185,8,26,34,135
"Grosek, Michal",F,06/01/1975,Vyskov,Czech Republic,526,84,137,221,509
"Grosenick, Troy",G,08/27/1989,"Brookfield, Wisconsin",United States,4,0,0,0,0
"Gross, Jordan",D,05/09/1995,"Maple Grove, Minnesota",United States,10,0,4,4,6
"Gross, Lloyd",F,09/05/1905,"Kitchener, Ontario",Canada,52,11,4,15,22
"Grossman, Niklas",D,01/22/1985,Stockholm,Sweden,592,13,73,86,314
"Grosso, Don",F,04/12/1915,"Sault Ste. Marie, Ontario",Canada,335,87,117,204,88
"Grosvenor, Leonard",F,07/21/1905,"Ottawa, Ontario",Canada,150,9,11,20,82
"Groulx, Benoit-Olivier",F,02/06/2000,"Gatineau, Quebec",Canada,18,1,2,3,2
"Groulx, Wayne",F,02/02/1965,"Welland, Ontario",Canada,1,0,0,0,0
"Grubauer, Philipp",G,11/25/1991,Rosenheim,Germany,269,0,4,4,2
"Gruden, John",D,06/04/1970,"Virginia, Minnesota",United States,92,1,8,9,46
"Gruen, Danny",F,06/26/1952,"Thunder Bay, Ontario",Canada,49,9,13,22,19
"Gruhl, Scott",F,09/13/1959,"Port Colborne, Ontario",Canada,20,3,3,6,6
"Grundström, Carl",F,12/01/1997,Umeå,Sweden,129,20,16,36,56
"Gryba, Eric",D,04/18/1988,"Saskatoon, Saskatchewan",Canada,289,7,36,43,368
"Gryp, Bob",F,05/06/1950,"Chatham, Ontario",Canada,74,11,13,24,33
"Grzelcyk, Matt",D,01/05/1994,"Charlestown, Massachusetts",United States,307,19,79,98,172
"Guay, Francois",F,06/08/1968,"Gatineau, Quebec",Canada,1,0,0,0,0
"Guay, Paul",F,09/02/1963,"Providence, Rhode Island",United States,117,11,23,34,92
"Gudas, Radko",D,06/05/1990,Prague,Czech Republic,610,31,116,147,764
"Gudbranson, Erik",D,01/07/1992,"Ottawa, Ontario",Canada,641,27,67,94,708
"Gudlevskis, Kristers",G,07/31/1992,Aizkraukle,Latvia,3,0,0,0,0
"Guenette, Steve",G,11/13/1965,"Gloucester, Ontario",Canada,35,0,1,1,4
"Guenin, Nate",D,12/10/1982,"Sewickley, Pennsylvania",United States,205,5,23,28,94
"Guentzel, Jake",F,10/06/1994,"Woodbury, Minnesota",United States,375,161,180,341,164
"Guerard, Daniel",F,04/07/1974,"LaSalle, Quebec",Canada,2,0,0,0,0
"Guerard, Stephane",D,04/12/1968,"Sainte-Elizabeth, Quebec",Canada,34,0,0,0,40
"Guerin, Bill",F,11/09/1970,"Worcester, Massachusetts",United States,1263,429,427,856,1660
"Guevremont, Jocelyn",D,03/01/1951,"Montréal, Quebec",Canada,571,84,223,307,319
"Guhle, Brendan",D,07/29/1997,"Edmonton, Alberta",Canada,65,4,10,14,24
"Guidolin, Aldo",D,06/06/1932,"Forks of the Credit, Ontario",Canada,182,9,15,24,117
"Guidolin, Bep",F,12/09/1925,"Thorold, Ontario",Canada,519,107,171,278,616
"Guindon, Bob",F,11/19/1950,"Labelle, Quebec",Canada,6,0,1,1,0
"Guite, Ben",F,07/17/1978,"Montréal, Quebec",Canada,175,19,26,45,97
"Gunnarsson, Carl",D,11/09/1986,Örebro,Sweden,629,30,108,138,179
"Guolla, Steve",F,03/15/1973,"Scarborough, Ontario",Canada,205,40,46,86,60
"Guren, Miloslav",D,09/24/1976,Uherske Hradiste,Czech Republic,36,1,3,4,16
"Guryanov, Denis",F,06/07/1997,Togliatti,Russia,214,44,50,94,50
"Gusarov, Alexei",D,07/08/1964,Saint Petersburg,Russia,607,39,128,167,313
"Gusev, Nikita",F,07/08/1992,Moscow,Russia,97,17,37,54,14
"Gusev, Sergei",D,07/31/1975,Nizhny Tagil,Russia,89,4,10,14,34
"Gusmanov, Ravil",F,07/25/1972,Naberezhnye Chelny,Russia,4,0,0,0,0
"Gustafson, Derek",G,06/21/1979,"Gresham, Oregon",United States,5,0,0,0,0
"Gustafsson, Bengt-Åke",F,03/23/1958,Karlskoga,Sweden,629,195,359,554,196
"Gustafsson, David",F,04/11/2000,Tingsryd,Sweden,28,1,0,1,0
"Gustafsson, Erik",D,12/15/1988,Kvissleby,Sweden,91,6,17,23,14
"Gustafsson, Erik",D,03/14/1992,Nynäshamn,Sweden,309,32,117,149,85
"Gustafsson, Per",D,06/04/1970,Oskarshamn,Sweden,89,8,27,35,38
"Gustavsson, Filip",G,06/07/1998,Skellefteå,Sweden,27,0,0,0,0
"Gustavsson, Jonas",G,10/24/1984,Danderyd,Sweden,179,0,4,4,10
"Gustavsson, Peter",F,03/30/1958,Bollebygd,Sweden,2,0,0,0,0
"Guy, Kevan",D,07/16/1965,"Edmonton, Alberta",Canada,156,5,20,25,138
"Haakana, Kari",D,11/08/1973,Outokumpu,Finland,13,0,0,0,4
"Haanpää, Ari",F,11/29/1965,Nokia,Finland,60,6,11,17,37
"Haapala, Henrik",F,02/28/1994,Lempäälä,Finland,5,0,1,1,0
"Haas, David",F,06/23/1968,"Toronto, Ontario",Canada,7,2,1,3,7
"Haas, Gaetan",F,01/31/1992,Bonfol,Switzerland,92,7,6,13,16
"Habscheid, Marc",F,03/01/1963,"Swift Current, Saskatchewan",Canada,345,72,91,163,171
"Hachborn, Leonard",F,09/09/1961,"Brantford, Ontario",Canada,102,20,39,59,29
"Hackett, Jeff",G,06/01/1968,"London, Ontario",Canada,500,0,9,9,62
"Hackett, Matt",G,03/07/1990,"London, Ontario",Canada,26,0,0,0,0
"Haddon, Lloyd",D,08/10/1938,"Sarnia, Ontario",Canada,8,0,0,0,2
"Hadfield, Vic",F,10/04/1940,"Oakville, Ontario",Canada,1004,323,389,712,1159
"Hagel, Brandon",F,08/27/1998,"Saskatoon, Saskatchewan",Canada,130,34,34,68,42
"Hagelin, Carl",F,08/23/1988,Nykvarn,Sweden,713,110,186,296,293
"Hägg, Robert",D,02/08/1995,Uppsala,Sweden,300,14,42,56,178
"Haggarty, Jim",F,04/14/1914,"Thunder Bay, Ontario",Canada,5,1,1,2,0
"Haggerty, Sean",F,02/11/1976,"Rye, New York",United States,14,1,2,3,4
"Hägglund, Roger",D,07/02/1961,Umeå,Sweden,3,0,0,0,0
"Hagman, Matti",F,09/21/1955,Helsinki,Finland,237,56,89,145,36
"Hagman, Niklas",F,12/05/1979,Espoo,Finland,770,147,154,301,220
"Hague, Nicolas",D,12/05/1998,"Kitchener, Ontario",Canada,142,10,32,42,101
"Hahl, Riku",F,11/01/1980,Hämeenlinna,Finland,92,5,8,13,38
"Hainsey, Ron",D,03/24/1981,"Bolton, Connecticut",United States,1132,59,252,311,443
"Hainsworth, George",G,06/26/1893,"Toronto, Ontario",Canada,465,0,0,0,4
"Hajdu, Richard",F,04/10/1965,"Victoria, British Columbia",Canada,5,0,0,0,4
"Hajek, Libor",D,02/04/1998,Smrcek,Czech Republic,94,3,8,11,36
"Hajt, Bill",D,11/18/1951,"Borden, Saskatchewan",Canada,854,42,202,244,433
"Hajt, Chris",D,07/05/1978,"Saskatoon, Saskatchewan",Canada,6,0,0,0,2
"Hakanpää, Jani",D,03/31/1992,Kirkkonummi,Finland,142,7,10,17,80
"Håkansson, Anders",F,04/27/1956,Munkfors,Sweden,330,52,46,98,141
"Halak, Jaroslav",G,05/13/1985,Bratislava,Slovakia,556,0,12,12,16
"Halbgewachs, Jayden",F,03/22/1997,"Emerald Park, Saskatchewan",Canada,3,0,1,1,4
"Halderson, Harold",D,01/06/1900,"Winnipeg, Manitoba",Canada,44,3,2,5,65
"Hale, David",D,06/18/1981,"Colorado Springs, Colorado",United States,327,4,25,29,242
"Hale, Larry",D,10/09/1941,"Summerland, British Columbia",Canada,196,5,37,42,90
"Haley, Len",F,09/15/1931,"Edmonton, Alberta",Canada,30,2,2,4,14
"Haley, Micheal",F,03/30/1986,"Guelph, Ontario",Canada,274,11,21,32,692
"Halischuk, Matt",F,06/01/1988,"Toronto, Ontario",Canada,280,33,42,75,57
"Halkidis, Bob",D,03/05/1966,"Toronto, Ontario",Canada,256,8,32,40,825
"Halko, Steve",D,03/08/1974,"Etobicoke, Ontario",Canada,155,0,15,15,71
"Hall, Adam",F,08/14/1980,"Kalamazoo, Michigan",United States,682,69,87,156,282
"Hall, Bob",F,10/13/1899,"Oak Park, Illinois",United States,8,0,0,0,0
"Hall, Del",F,05/07/1949,"Peterborough, Ontario",Canada,9,2,0,2,2
"Hall, Glenn",G,10/03/1931,"Humboldt, Saskatchewan",Canada,906,0,9,9,98
"Hall, Joe",F,05/03/1881,"Staffordshire, England",United Kingdom,37,15,9,24,230
"Hall, Murray",F,11/24/1940,"Kirkland Lake, Ontario",Canada,164,35,48,83,42
"Hall, Taylor",F,02/20/1964,"Regina, Saskatchewan",Canada,41,7,9,16,29
"Hall, Taylor",F,11/14/1991,"Calgary, Alberta",Canada,761,248,409,657,418
"Hall, Wayne",F,05/22/1939,"Melita, Manitoba",Canada,4,0,0,0,0
"Hållander, Filip",F,06/29/2000,Sundsvall,Sweden,1,0,0,0,0
"Haller, Kevin",D,12/05/1970,"Trochu, Alberta",Canada,642,41,97,138,907
"Halliday, Milt",D,09/21/1906,"Ottawa, Ontario",Canada,67,1,0,1,4
"Hallin, Mats",F,03/19/1958,Eskilstuna,Sweden,152,17,14,31,193
"Halmo, Mike",F,05/11/1991,"Waterloo, Ontario",Canada,20,1,0,1,32
"Halpern, Jeff",F,05/03/1976,"Potomac, Maryland",United States,976,152,221,373,641
"Halverson, Brandon",G,03/29/1996,"Traverse City, Michigan",United States,1,0,0,0,0
"Halverson, Trevor",F,04/06/1971,"White River, Ontario",Canada,17,0,4,4,28
"Halward, Doug",D,11/01/1955,"Toronto, Ontario",Canada,653,69,224,293,774
"Hamel, Denis",F,05/10/1977,"Lachute, Quebec",Canada,192,19,12,31,77
"Hamel, Gilles",F,03/18/1960,"Asbestos, Quebec",Canada,519,127,147,274,276
"Hamel, Herbert 'Hap'",F,06/08/1904,"New Hamburg, Ontario",Canada,2,0,0,0,4
"Hamel, Jean",D,06/06/1952,"Asbestos, Quebec",Canada,699,26,95,121,766
"Hamel, Pierre",G,09/16/1952,"Montréal, Quebec",Canada,69,0,3,3,16
"Hamhuis, Dan",D,12/13/1982,"Smithers, British Columbia",Canada,1148,59,297,356,684
"Hamill, Robert 'Red'",F,01/11/1917,"Toronto, Ontario",Canada,429,128,94,222,170
"Hamill, Zach",F,09/23/1988,"Port Coquitlam, British Columbia",Canada,20,0,4,4,4
"Hamilton, Al",D,08/20/1946,"Flin Flon, Manitoba",Canada,257,10,78,88,258
"Hamilton, Chuck",F,01/18/1939,"Kirkland Lake, Ontario",Canada,4,0,2,2,2
"Hamilton, Curtis",F,12/04/1991,"Tacoma, Washington",United States,1,0,0,0,5
"Hamilton, Dougie",D,06/17/1993,"Toronto, Ontario",Canada,669,115,256,371,424
"Hamilton, Freddie",F,01/01/1992,"Toronto, Ontario",Canada,75,4,2,6,12
"Hamilton, Jackie",F,06/02/1925,"Trenton, Ontario",Canada,102,28,32,60,20
"Hamilton, Jeff",F,09/04/1977,"Englewood, Ohio",United States,157,32,45,77,44
"Hamilton, Jim",F,01/18/1957,"Barrie, Ontario",Canada,95,14,18,32,28
"Hamilton, Reg",D,04/29/1914,"Toronto, Ontario",Canada,425,21,87,108,412
"Hamilton, Ryan",F,04/15/1985,"Oshawa, Ontario",Canada,30,1,4,5,8
"Hammarström, Inge",F,01/20/1948,Sundsvall,Sweden,427,116,123,239,86
"Hammond, Andrew",G,02/11/1988,"Surrey, British Columbia",Canada,67,0,1,1,2
"Hammond, Ken",D,08/22/1963,"Port Credit, Ontario",Canada,193,18,29,47,290
"Hamonic, Travis",D,08/16/1990,"St. Malo, Manitoba",Canada,718,44,164,208,644
"Hampson, Gord",F,02/13/1959,"Vancouver, British Columbia",Canada,4,0,0,0,5
"Hampson, Ted",F,12/11/1936,"Togo, Saskatchewan",Canada,677,108,245,353,92
"Hampton, Rick",D,07/14/1956,"Toronto, Ontario",Canada,337,59,113,172,147
"Hamr, Radek",D,06/15/1974,Usti nad Labem,Czech Republic,11,0,0,0,0
"Hamrlík, Roman",D,04/12/1974,Zlin,Czech Republic,1395,155,483,638,1408
"Hamway, Mark",F,08/09/1961,"Detroit, Michigan",United States,53,5,13,18,9
"Händemark, Fredrik",F,08/27/1993,Björbo,Sweden,8,1,0,1,2
"Handy, Ron",F,01/15/1963,"Toronto, Ontario",Canada,14,0,3,3,0
"Handzus, Michal",F,03/11/1977,Banska Bystrica,Slovakia,1009,185,298,483,498
"Hangsleben, Alan",D,02/22/1953,"Warroad, Minnesota",United States,185,21,48,69,396
"Hanifin, Noah",D,01/25/1997,"Norwood, Massachusetts",United States,517,42,159,201,130
"Hankinson, Ben",F,05/01/1969,"Edina, Minnesota",United States,43,3,3,6,45
"Hankinson, Casey",F,05/08/1976,"Edina, Minnesota",United States,18,0,1,1,13
"Hanley, Joel",D,06/08/1991,"Keswick, Ontario",Canada,125,2,20,22,18
"Hanlon, Glen",G,02/20/1957,"Brandon, Manitoba",Canada,476,0,11,11,210
"Hanna, John",D,04/05/1935,"Sydney, Nova Scotia",Canada,198,6,26,32,206
"Hannan, Dave",F,11/26/1961,"Sudbury, Ontario",Canada,841,114,191,305,942
"Hannan, Scott",D,01/23/1979,"Richmond, British Columbia",Canada,1055,38,179,217,625
"Hannigan, Gord",F,01/19/1929,"Timmins, Ontario",Canada,161,29,31,60,115
"Hannigan, Pat",F,03/05/1936,"Timmins, Ontario",Canada,182,30,39,69,116
"Hannigan, Ray",F,07/14/1927,"Timmins, Ontario",Canada,3,0,0,0,2
"Hännikäinen, Markus",F,03/26/1993,Helsinki,Finland,91,8,7,15,14
"Hanowski, Ben",F,10/18/1990,"Little Falls, Minnesota",United States,16,1,2,3,2
"Hansen, Jannik",F,03/15/1986,Herlev,Denmark,626,109,147,256,282
"Hansen, Richie",F,10/30/1955,"Northport, New York",United States,20,2,8,10,4
"Hansen, Tavis",F,06/17/1975,"Prince Albert, Saskatchewan",Canada,34,2,1,3,16
"Hanson, Christian",F,03/10/1986,"Venetia, Pennsylvania",United States,42,3,6,9,22
"Hanson, Dave",D,04/12/1954,"Cumberland, Wisconsin",United States,33,1,1,2,65
"Hanson, Emil",D,11/18/1907,"Camrose, Alberta",Canada,7,0,0,0,6
"Hanson, Keith",D,04/26/1957,"Ada, Minnesota",United States,25,0,2,2,77
"Hanson, Oscar",F,12/27/1909,"Camrose, Alberta",Canada,8,0,0,0,0
"Hanzal, Martin",F,02/20/1987,Pisek,Czech Republic,673,127,211,338,574
"Harbaruk, Nick",F,08/16/1943,Drohiczyn,Poland,364,45,75,120,273
"Harding, Jeff",F,04/06/1969,"Toronto, Ontario",Canada,15,0,0,0,47
"Harding, Josh",G,06/18/1984,"Regina, Saskatchewan",Canada,151,0,2,2,6
"Hardman, Mike",F,02/05/1999,"Hanover, Massachusetts",United States,29,1,4,5,11
"Hardy, Joe",F,12/05/1945,"Kenogami, Quebec",Canada,63,9,14,23,51
"Hardy, Mark",D,02/01/1959,Samedan,Switzerland,915,62,306,368,1293
"Hargreaves, Jim",D,05/02/1950,"Winnipeg, Manitoba",Canada,66,1,7,8,105
"Harju, Johan",F,05/15/1986,Övertorneå,Sweden,10,1,2,3,2
"Harkins, Brett",F,07/02/1970,"North Ridgeville, Ohio",United States,78,6,30,36,22
"Harkins, Jansen",F,05/23/1997,"North Vancouver, British Columbia",Canada,132,10,12,22,24
"Harkins, Todd",F,10/08/1968,"Cleveland, Ohio",United States,48,3,3,6,78
"Harley, Thomas",D,08/19/2001,"Syracuse, New York",United States,34,1,3,4,6
"Harlock, David",D,03/16/1971,"Toronto, Ontario",Canada,212,2,14,16,188
"Harlow, Scott",F,10/11/1963,"East Bridgewater, Massachusetts",United States,1,0,1,1,0
"Harmon, Glen",D,01/02/1921,"Holland, Manitoba",Canada,453,50,96,146,334
"Harms, Johnny",F,04/25/1925,"Saskatoon, Saskatchewan",Canada,44,5,5,10,21
"Harnott, Walter",F,09/24/1909,"Montréal, Quebec",Canada,6,0,0,0,2
"Harper, Shane",F,02/01/1989,"Valencia, California",United States,14,2,1,3,18
"Harper, Terry",D,01/27/1940,"Regina, Saskatchewan",Canada,1066,35,221,256,1364
"Harpur, Ben",D,01/12/1995,"Niagara-on-the-Lake, Ontario",Canada,156,1,14,15,123
"Harrer, Tim",F,05/10/1957,"Bloomington, Minnesota",United States,3,0,0,0,2
"Harrington, Hago",F,08/13/1904,"Melrose, Massachusetts",United States,72,9,5,14,31
"Harrington, Scott",D,03/10/1993,"Kingston, Ontario",Canada,210,7,31,38,77
"Harris, Billy",F,07/29/1935,"Toronto, Ontario",Canada,770,126,219,345,193
"Harris, Billy",F,01/29/1952,"Toronto, Ontario",Canada,897,231,327,558,394
"Harris, Duke",F,02/25/1942,"Sarnia, Ontario",Canada,26,1,4,5,4
"Harris, Henry",F,04/28/1906,"Kenora, Ontario",Canada,32,2,4,6,20
"Harris, Hugh",F,06/07/1948,"Toronto, Ontario",Canada,60,12,26,38,17
"Harris, Jordan",D,07/07/2000,"Haverhill, Massachusetts",United States,10,1,0,1,8
"Harris, Ron",D,06/30/1942,"Verdun, Quebec",Canada,475,20,91,111,474
"Harris, Smokey",F,10/11/1890,"Thunder Bay, Ontario",Canada,6,3,1,4,8
"Harris, Ted",D,07/18/1936,"Winnipeg, Manitoba",Canada,788,30,168,198,1000
"Harrison, Ed",F,07/25/1927,"Mimico, Ontario",Canada,194,27,24,51,51
"Harrison, Jay",D,11/03/1982,"Oshawa, Ontario",Canada,372,23,52,75,360
"Harrison, Jim",F,07/09/1947,"Bonnyville, Alberta",Canada,324,67,86,153,435
"Harrison, Paul",G,02/11/1955,"Timmins, Ontario",Canada,109,0,1,1,28
"Harrold, Peter",D,06/08/1983,"Kirtland Hills, Ohio",United States,274,13,29,42,74
"Hart, Carter",G,08/13/1998,"Sherwood Park, Alberta",Canada,146,0,1,1,2
"Hart, Gerry",D,01/01/1948,"Flin Flon, Manitoba",Canada,730,29,150,179,1240
"Hart, Harold 'Gizzy'",F,06/01/1902,"Weyburn, Saskatchewan",Canada,99,6,9,15,12
"Hartigan, Mark",F,10/15/1977,"Fort St. John, British Columbia",Canada,102,19,11,30,58
"Hartikainen, Teemu",F,05/03/1990,Kuopio,Finland,52,6,7,13,16
"Hartman, Mike",F,02/07/1967,"Detroit, Michigan",United States,397,43,35,78,1388
"Hartman, Ryan",F,09/20/1994,"Hilton Head Island, South Carolina",United States,447,92,104,196,415
"Hartnell, Scott",F,04/18/1982,"Regina, Saskatchewan",Canada,1249,327,380,707,1809
"Hartsburg, Craig",D,06/29/1959,"Stratford, Ontario",Canada,570,98,315,413,815
"Harvey, Buster",F,04/02/1950,"Fredericton, New Brunswick",Canada,407,90,118,208,131
"Harvey, Doug",D,12/19/1924,"Montréal, Quebec",Canada,1113,88,452,540,1225
"Harvey, Hugh",F,06/25/1949,"Kingston, Ontario",Canada,18,1,1,2,4
"Harvey, Todd",F,02/17/1975,"Hamilton, Ontario",Canada,671,91,132,223,950
"Harvey-Pinard, Rafael",F,01/06/1999,"Jonquière, Quebec",Canada,4,1,0,1,0
"Hasek, Dominik",G,01/29/1965,Pardubice,Czech Republic,735,0,19,19,170
"Hassard, Bob",F,03/26/1929,"Lloydminster, Saskatchewan",Canada,126,9,28,37,22
"Hatakka, Santeri",D,01/15/2001,Riihimäki,Finland,9,0,2,2,2
"Hatcher, Derian",D,06/04/1972,"Sterling Heights, Michigan",United States,1045,80,251,331,1581
"Hatcher, Kevin",D,09/09/1966,"Detroit, Michigan",United States,1157,227,450,677,1392
"Hathaway, Garnet",F,11/23/1991,"Naples, Florida",United States,373,45,55,100,421
"Hatoum, Ed",F,12/07/1947,Beirut,Lebanon,47,3,6,9,25
"Hauer, Brett",D,07/11/1971,"Richfield, Minnesota",United States,37,4,4,8,38
"Haula, Erik",F,03/23/1991,Pori,Finland,534,112,128,240,243
"Hauser, Adam",G,05/27/1980,"Bovey, Minnesota",United States,1,0,0,0,0
"Hävelid, Niclas",D,04/12/1973,Enköping,Sweden,628,34,137,171,342
"Havlát, Martin",F,04/19/1981,Mlada Boleslav,Czech Republic,790,242,352,594,404
"Hawerchuk, Dale",F,04/04/1963,"Toronto, Ontario",Canada,1188,518,891,1409,740
"Hawgood, Greg",D,08/10/1968,"Edmonton, Alberta",Canada,474,60,164,224,426
"Hawkins, Todd",F,08/02/1966,"Kingston, Ontario",Canada,10,0,0,0,15
"Haworth, Alan",F,09/01/1960,"Drummondville, Quebec",Canada,524,189,211,400,425
"Haworth, Gordie",F,02/20/1932,"Drummondville, Quebec",Canada,2,0,1,1,0
"Hawryliw, Neil",F,11/19/1957,"Fielding, Saskatchewan",Canada,1,0,0,0,0
"Hawryluk, Jayce",F,01/01/1996,"Yorkton, Saskatchewan",Canada,98,12,15,27,41
"Hay, Bill",F,12/09/1935,"Lumsden, Saskatchewan",Canada,506,113,273,386,244
"Hay, Dwayne",F,02/11/1977,"London, Ontario",Canada,79,2,4,6,22
"Hay, George",F,01/10/1898,"Listowel, Ontario",Canada,240,74,62,136,87
"Hay, Jim",D,05/15/1931,"Saskatoon, Saskatchewan",Canada,75,1,5,6,22
"Haydar, Darren",F,10/22/1979,"Toronto, Ontario",Canada,23,1,7,8,2
"Hayden, John",F,02/14/1995,"Chicago, Illinois",United States,240,15,20,35,283
"Hayek, Peter",D,11/16/1957,"Minneapolis, Minnesota",United States,1,0,0,0,0
"Hayes, Eriah",F,07/07/1988,"La Cresent, Minnesota",United States,19,1,0,1,4
"Hayes, Jimmy",F,11/21/1989,"Boston, Massachusetts",United States,334,54,55,109,149
"Hayes, Kevin",F,05/08/1992,"Dorchester, Massachusetts",United States,553,137,195,332,182
"Hayes, Zackary",D,04/24/1999,"Calgary, Alberta",Canada,3,0,0,0,0
"Haynes, Paul",F,03/01/1910,"Montréal, Quebec",Canada,384,61,133,194,164
"Hayton, Barrett",F,06/09/2000,"Peterborough, Ontario",Canada,94,13,18,31,34
"Hayward, Brian",G,06/25/1960,"Weston, Ontario",Canada,357,0,13,13,85
"Hayward, Rick",D,02/25/1966,"Toledo, Ohio",United States,4,0,0,0,5
"Hazlett, Steve",F,12/12/1957,"Sarnia, Ontario",Canada,1,0,0,0,0
"Head, Don",G,06/30/1933,"Mt. Dennis, Ontario",Canada,38,0,0,0,14
"Head, Galen",F,04/16/1947,"Grande Prairie, Alberta",Canada,1,0,0,0,0
"Headley, Fern",D,03/02/1901,"Crystal, North Dakota",United States,30,1,4,5,6
"Healey, Eric",F,01/20/1975,"Hull, Massachusetts",United States,2,0,0,0,2
"Healey, Paul",F,03/20/1975,"Edmonton, Alberta",Canada,77,6,14,20,44
"Healey, Rich",D,03/12/1938,"Vancouver, British Columbia",Canada,1,0,0,0,2
"Healy, Glenn",G,08/23/1962,"Pickering, Ontario",Canada,437,0,15,15,93
"Heaphy, Shawn",F,11/27/1968,"Sudbury, Ontario",Canada,1,0,0,0,0
"Heaslip, Mark",F,12/26/1951,"Duluth, Minnesota",United States,117,10,19,29,110
"Heath, Randy",F,11/11/1964,"Vancouver, British Columbia",Canada,13,2,4,6,15
"Heatherington, Dillon",D,05/09/1995,"Calgary, Alberta",Canada,20,0,2,2,33
"Heatley, Dany",F,01/21/1981,Freiburg,Germany,869,372,419,791,620
"Hebenton, Andy",F,10/03/1929,"Winnipeg, Manitoba",Canada,630,189,202,391,88
"Hebert, Guy",G,01/07/1967,"Troy, New York",United States,491,0,6,6,22
"Hebert, Sammy",G,03/31/1894,"Ottawa, Ontario",Canada,4,0,0,0,0
"Hecht, Jochen",F,06/21/1977,Mannheim,Germany,833,186,277,463,458
"Hecl, Radoslav",D,10/11/1974,Partizanske,Slovakia,14,0,0,0,2
"Hedberg, Anders",F,02/25/1951,Örnsköldsvik,Sweden,465,172,225,397,144
"Hedberg, Johan",G,05/05/1973,Leksand,Sweden,373,0,10,10,96
"Hedican, Bret",D,08/10/1970,"St. Paul, Minnesota",United States,1039,55,239,294,893
"Hedin, Pierre",D,02/19/1978,Örnsköldsvik,Sweden,3,0,1,1,0
"Hedman, Victor",D,12/18/1990,Örnsköldsvik,Sweden,898,134,469,603,624
"Hedström, Jonathan",F,12/27/1977,Skellefteå,Sweden,83,13,14,27,48
"Heed, Tim",D,01/27/1991,Göteborg,Sweden,105,6,23,29,20
"Heerema, Jeff",F,01/17/1980,"Thunder Bay, Ontario",Canada,32,4,2,6,6
"Heeter, Cal",G,11/02/1988,"St. Louis, Missouri",United States,1,0,0,0,0
"Heffernan, Frank",F,01/12/1892,"Peterborough, Ontario",Canada,19,0,1,1,10
"Heffernan, Gerald",F,07/24/1916,"Montréal, Quebec",Canada,85,33,35,68,27
"Heidt, Mike",D,11/04/1963,"Calgary, Alberta",Canada,6,0,1,1,7
"Heikkinen, Ilkka",D,11/13/1984,Rauma,Finland,7,0,0,0,0
"Heindl, Bill",F,05/13/1946,"Sherbrooke, Quebec",Canada,18,2,1,3,0
"Heinen, Danton",F,07/05/1995,"Langley, British Columbia",Canada,348,62,92,154,60
"Heinola, Ville",D,03/02/2001,Honkajoki,Finland,25,1,9,10,16
"Heinrich, Lionel",F,04/20/1934,"Churchbridge, Saskatchewan",Canada,35,1,1,2,33
"Heins, Shawn",D,12/24/1973,"Eganville, Ontario",Canada,125,4,12,16,154
"Heinz, Rick",G,05/30/1955,"Essex, Ontario",Canada,49,0,1,1,6
"Heinze, Steve",F,01/30/1970,"Lawrence, Massachusetts",United States,694,178,158,336,379
"Heiskala, Earl",F,11/30/1942,"Kirkland Lake, Ontario",Canada,127,13,11,24,294
"Heiskanen, Miro",D,07/18/1999,Espoo,Finland,275,33,98,131,64
"Heisten, Barrett",F,03/19/1980,"Anchorage, Alaska",United States,10,0,0,0,2
"Hejda, Jan",D,06/18/1978,Prague,Czech Republic,627,25,110,135,317
"Hejduk, Milan",F,02/14/1976,Usti nad Labem,Czech Republic,1020,375,430,805,316
"Helander, Peter",D,12/04/1951,Stockholm,Sweden,7,0,1,1,0
"Helbling, Timo",D,07/21/1981,Basel,Switzerland,11,0,1,1,8
"Helenius, Riku",G,03/01/1988,Pälkäne,Finland,1,0,0,0,0
"Helenius, Sami",D,01/22/1974,Hyvinkää,Finland,155,2,4,6,260
"Helgeson, Seth",D,10/08/1990,"Faribault, Minnesota",United States,50,1,3,4,50
"Hellberg, Magnus",G,04/04/1991,Uppsala,Sweden,5,0,0,0,0
"Hellebuyck, Connor",G,05/19/1993,"Commerce, Michigan",United States,381,0,9,9,4
"Heller, Ott",D,06/02/1910,"Kitchener, Ontario",Canada,649,54,176,230,467
"Helm, Darren",F,01/21/1987,"Winnipeg, Manitoba",Canada,812,119,147,266,252
"Helman, Harry",D,08/28/1894,"Ottawa, Ontario",Canada,44,1,0,1,7
"Helmer, Bryan",D,07/15/1972,"Sault Ste. Marie, Ontario",Canada,146,8,18,26,135
"Helminen, Dwight",F,06/22/1983,"Hancock, Michigan",United States,27,2,1,3,0
"Helminen, Raimo",F,03/11/1964,Tampere,Finland,117,13,46,59,16
"Hemingway, Colin",F,08/12/1980,"Surrey, British Columbia",Canada,3,0,0,0,0
"Hemmerling, Tony",F,05/15/1914,"Landis, Saskatchewan",Canada,22,3,3,6,4
"Hemsky, Ales",F,08/13/1983,Pardubice,Czech Republic,845,174,398,572,353
"Henderson, Archie",F,02/17/1957,"Calgary, Alberta",Canada,23,3,1,4,92
"Henderson, Jay",F,09/17/1978,"Edmonton, Alberta",Canada,33,1,3,4,37
"Henderson, John",G,03/25/1933,"Toronto, Ontario",Canada,46,0,0,0,0
"Henderson, Kevin",F,12/03/1986,"Toronto, Ontario",Canada,4,1,0,1,0
"Henderson, Matt",F,03/01/1974,"White Bear Lake, Minnesota",United States,6,0,1,1,2
"Henderson, Murray",D,09/05/1921,"Toronto, Ontario",Canada,405,24,62,86,305
"Henderson, Paul",F,01/28/1943,"Kincardine, Ontario",Canada,707,236,241,477,304
"Hendricks, Matt",F,06/17/1981,"Blaine, Minnesota",United States,607,54,62,116,722
"Hendrickson, Darby",F,08/28/1972,"Richfield, Minnesota",United States,518,65,64,129,370
"Hendrickson, Jack",D,12/05/1936,"Kingston, Ontario",Canada,5,0,0,0,4
"Hendry, Jordan",D,02/23/1984,"Nokomis, Saskatchewan",Canada,131,4,9,13,40
"Henley, Sam",F,07/25/1993,"Val-d'Or, Quebec",Canada,1,1,0,1,2
"Hennessy, Josh",F,02/07/1985,"Brockton, Massachusetts",United States,23,1,0,1,6
"Henning, Lorne",F,02/22/1952,"Melfort, Saskatchewan",Canada,543,73,111,184,102
"Henrique, Adam",F,02/06/1990,"Brantford, Ontario",Canada,768,217,224,441,229
"Henry, Alex",D,10/18/1979,"Elliot Lake, Ontario",Canada,177,2,9,11,269
"Henry, Burke",D,01/21/1979,"Ste. Rose, Manitoba",Canada,39,2,6,8,33
"Henry, Camille",F,01/31/1933,"Québec City, Quebec",Canada,727,279,249,528,82
"Henry, Dale",F,09/24/1964,"Prince Albert, Saskatchewan",Canada,132,13,26,39,263
"Henry, Gordie",G,08/17/1926,"Owen Sound, Ontario",Canada,3,0,0,0,0
"Henry, Jim",G,10/23/1920,"Winnipeg, Manitoba",Canada,405,0,0,0,0
"Hensick, T.J.",F,12/10/1985,"Lansing, Michigan",United States,112,12,26,38,18
"Hentunen, Jukka",F,05/03/1974,Joroinen,Finland,38,4,5,9,4
"Heponiemi, Aleksi",F,01/09/1999,Tampere,Finland,15,1,2,3,4
"Hepple, Alan",D,08/16/1963,"Blaydon-on-Tyne, England",United Kingdom,3,0,0,0,7
"Herbers, Ian",D,07/18/1967,"Jasper, Alberta",Canada,65,0,5,5,79
"Herberts, Jimmy",F,10/31/1897,"Cayuga, Ontario",Canada,206,83,34,117,259
"Herchenratter, Art",F,11/24/1917,"Kitchener, Ontario",Canada,10,1,2,3,2
"Hergerts, Fred",F,01/29/1913,"Calgary, Alberta",Canada,20,2,4,6,2
"Hergesheimer, Phil",F,07/09/1914,"Winnipeg, Manitoba",Canada,125,21,41,62,29
"Hergesheimer, Wally",F,01/08/1927,"Winnipeg, Manitoba",Canada,351,114,85,199,106
"Heron, Robert 'Red'",F,12/31/1917,"Toronto, Ontario",Canada,106,21,19,40,38
"Heroux, Yves",F,04/27/1965,"Terrebonne, Quebec",Canada,1,0,0,0,0
"Herperger, Chris",F,02/24/1974,"Esterhazy, Saskatchewan",Canada,169,18,25,43,75
"Herr, Matt",F,05/26/1976,"Hackensack, New Jersey",United States,58,4,5,9,25
"Herron, Denis",G,06/18/1952,"Chambly, Quebec",Canada,462,0,9,9,89
"Herter, Jason",D,10/02/1970,"Hafford, Saskatchewan",Canada,1,0,1,1,0
"Hertl, Tomas",F,11/12/1993,Prague,Czech Republic,585,181,206,387,192
"Heshka, Shaun",D,07/30/1985,"Melville, Saskatchewan",Canada,8,0,2,2,4
"Hess, Bob",D,05/19/1955,"Middleton, Nova Scotia",Canada,329,27,95,122,178
"Heward, Jamie",D,03/30/1971,"Regina, Saskatchewan",Canada,394,38,86,124,221
"Heximer, Orville",F,02/16/1910,"Niagara Falls, Ontario",Canada,84,13,7,20,16
"Hextall, Bryan",F,05/23/1941,"Winnipeg, Manitoba",Canada,549,99,161,260,736
"Hextall, Bryan",F,07/31/1913,"Grenfell, Saskatchewan",Canada,449,187,180,367,227
"Hextall, Dennis",F,04/17/1943,"Poplar Point, Manitoba",Canada,681,153,350,503,1398
"Hextall, Ron",G,05/03/1964,"Brandon, Manitoba",Canada,608,1,32,33,569
"Heyliger, Vic",F,09/26/1919,"Boston, Massachusetts",United States,33,2,3,5,2
"Hicke, Bill",F,03/31/1938,"Regina, Saskatchewan",Canada,729,168,234,402,389
"Hicke, Ernie",F,11/07/1947,"Regina, Saskatchewan",Canada,520,132,140,272,407
"Hicketts, Joe",D,05/04/1996,"Kamloops, British Columbia",Canada,22,0,5,5,4
"Hickey, Greg",F,03/08/1955,"Toronto, Ontario",Canada,1,0,0,0,0
"Hickey, Pat",F,05/15/1953,"Brantford, Ontario",Canada,644,192,212,404,351
"Hickey, Thomas",D,02/08/1989,"Calgary, Alberta",Canada,456,22,95,117,190
"Hicks, Alex",F,09/04/1969,"Calgary, Alberta",Canada,258,25,54,79,247
"Hicks, Doug",D,05/28/1955,"Cold Lake, Alberta",Canada,561,37,131,168,442
"Hicks, Glenn",F,08/28/1958,"Red Deer, Alberta",Canada,108,6,12,18,127
"Hicks, Hal",D,12/10/1900,"Sillery, Quebec",Canada,90,5,2,7,69
"Hicks, Wayne",F,04/09/1937,"Aberdeen, Washington",United States,115,13,23,36,20
"Hidi, Andre",F,06/05/1960,"Toronto, Ontario",Canada,7,2,1,3,9
"Hiemer, Uli",D,09/21/1962,Füssen,Germany,143,19,54,73,176
"Higgins, Chris",F,06/02/1983,"Smithtown, New York",United States,711,165,168,333,220
"Higgins, Matt",F,10/29/1977,"Calgary, Alberta",Canada,57,1,2,3,6
"Higgins, Paul",F,01/13/1962,"Saint John, New Brunswick",Canada,26,0,0,0,152
"Higgins, Tim",F,02/07/1958,"Ottawa, Ontario",Canada,706,154,198,352,719
"Highmore, Matthew",F,02/27/1996,"Halifax, Nova Scotia",Canada,137,12,15,27,28
"Highton, Hec",G,12/10/1923,"Medicine Hat, Alberta",Canada,24,0,0,0,0
"Hilbert, Andy",F,02/06/1981,"Lansing, Michigan",United States,307,42,62,104,132
"Hildebrand, Ike",F,05/27/1927,"Winnipeg, Manitoba",Canada,41,7,11,18,16
"Hill, Adin",G,05/11/1996,"Calgary, Alberta",Canada,74,0,1,1,2
"Hill, Al",F,04/22/1955,"Nanaimo, British Columbia",Canada,221,40,55,95,227
"Hill, Brian",F,01/12/1957,"Regina, Saskatchewan",Canada,19,1,1,2,4
"Hill, Mel",F,02/15/1914,"Glenboro, Manitoba",Canada,324,89,108,197,136
"Hill, Sean",D,02/14/1970,"Duluth, Minnesota",United States,876,62,236,298,1008
"Hillen, Jack",D,01/24/1986,"Minnetonka, Minnesota",United States,304,13,58,71,157
"Hiller, Jim",F,05/15/1969,"Port Alberni, British Columbia",Canada,63,8,12,20,116
"Hiller, Jonas",G,02/12/1982,Felben Wellhausen,Switzerland,404,0,8,8,2
"Hiller, Wilbert",F,05/11/1915,"Kitchener, Ontario",Canada,382,91,112,203,163
"Hillier, Randy",D,03/30/1960,"Toronto, Ontario",Canada,543,16,110,126,906
"Hillis, Cameron",F,06/24/2000,"Oshawa, Ontario",Canada,1,0,0,0,0
"Hillman, Blake",D,01/26/1996,"Elk River, Minnesota",United States,4,1,0,1,0
"Hillman, Floyd 'Bud'",D,11/19/1933,"Ruthven, Ontario",Canada,6,0,0,0,10
"Hillman, Larry",D,02/05/1937,"Kirkland Lake, Ontario",Canada,789,36,196,232,565
"Hillman, Wayne",D,11/13/1938,"Kirkland Lake, Ontario",Canada,691,18,86,104,532
"Hilworth, John",D,05/23/1957,"Jasper, Alberta",Canada,57,1,1,2,89
"Himes, Norman",F,04/13/1903,"Galt, Ontario",Canada,402,107,112,219,125
"Hindmarch, Dave",F,10/15/1958,"Vancouver, British Columbia",Canada,99,21,17,38,25
"Hinostroza, Vince",F,04/03/1994,"Bartlett, Illinois",United States,334,51,86,137,93
"Hinote, Dan",F,01/30/1977,"Leesburg, Florida",United States,503,38,52,90,383
"Hinse, Andre",F,04/19/1945,"Trois-Rivières, Quebec",Canada,4,0,0,0,0
"Hinton, Dan",F,05/24/1953,"Toronto, Ontario",Canada,14,0,0,0,16
"Hintz, Roope",F,11/17/1996,Tampere,Finland,239,80,90,170,72
"Hirose, Taro",F,06/30/1996,"Calgary, Alberta",Canada,57,4,16,20,12
"Hirsch, Corey",G,07/01/1972,"Medicine Hat, Alberta",Canada,108,0,3,3,8
"Hirsch, Tom",D,01/27/1963,"Minneapolis, Minnesota",United States,31,1,7,8,30
"Hirschfeld, Bert",F,03/01/1929,"Halifax, Nova Scotia",Canada,33,1,4,5,2
"Hischier, Nico",F,01/04/1999,Naters,Switzerland,300,78,128,206,83
"Hishon, Joey",F,10/20/1991,"Stratford, Ontario",Canada,13,1,1,2,0
"Hislop, Jamie",F,01/20/1954,"Sarnia, Ontario",Canada,345,75,103,178,86
"Hitchman, Lionel",D,11/03/1901,"Toronto, Ontario",Canada,417,27,38,65,557
"Hjalmarsson, Niklas",D,06/06/1987,Eksjö,Sweden,821,25,147,172,332
"Hlavác, Jan",F,09/20/1976,Prague,Czech Republic,436,90,134,224,138
"Hlinka, Ivan",F,01/26/1950,Most,Czech Republic,137,42,81,123,28
"Hlinka, Jaroslav",F,11/10/1976,Prague,Czech Republic,63,8,20,28,16
"Hlushko, Todd",F,02/07/1970,"Toronto, Ontario",Canada,79,8,13,21,84
"Hnidy, Shane",D,11/08/1975,"Neepawa, Manitoba",Canada,550,16,55,71,633
"Hnilicka, Milan",G,06/24/1973,Litomerice,Czech Republic,121,0,2,2,14
"Ho-Sang, Joshua",F,01/22/1996,"Toronto, Ontario",Canada,53,7,17,24,20
"Hocking, Justin",D,01/09/1974,"Stettler, Alberta",Canada,1,0,0,0,0
"Hodge, Charlie",G,07/28/1933,"Lachine, Quebec",Canada,358,0,0,0,10
"Hodge, Ken",F,04/13/1966,"Windsor, Ontario",Canada,142,39,48,87,32
"Hodge, Ken",F,06/25/1944,"Birmingham, England",United Kingdom,880,328,472,800,777
"Hodges, Tom",G,06/25/1993,"Shrewsbury, England",United Kingdom,1,0,0,0,0
"Hodgman, Justin",F,06/27/1988,"Brampton, Ontario",Canada,5,1,0,1,2
"Hodgson, Cody",F,02/18/1990,"Toronto, Ontario",Canada,328,64,78,142,68
"Hodgson, Dan",F,08/29/1965,"Fort Vermilion, Alberta",Canada,114,29,45,74,64
"Hodgson, Hayden",F,03/02/1996,"Leamington, Ontario",Canada,6,1,2,3,11
"Hodgson, Rick",F,05/23/1956,"Medicine Hat, Alberta",Canada,6,0,0,0,6
"Hodgson, Ted",F,06/30/1945,"Hobbema, Alberta",Canada,4,0,0,0,0
"Hodson, Kevin",G,03/27/1972,"Winnipeg, Manitoba",Canada,71,0,1,1,6
"Hoekstra, Cecil",F,04/02/1935,"Winnipeg, Manitoba",Canada,4,0,0,0,0
"Hoekstra, Ed",F,11/04/1937,"Winnipeg, Manitoba",Canada,70,15,21,36,6
"Hoene, Phil",F,03/15/1949,"Duluth, Minnesota",United States,37,2,4,6,22
"Hofer, Joel",G,07/30/2000,"Winnipeg, Manitoba",Canada,2,0,1,1,0
"Hoffinger, Vic",D,01/01/1901,Lymans'ke,Ukraine,28,0,1,1,28
"Hoffman, Mike",F,11/24/1989,"Kitchener, Ontario",Canada,612,204,226,430,219
"Hoffman, Mike",F,02/26/1963,"Cambridge, Ontario",Canada,9,1,3,4,2
"Hoffmeyer, Bob",D,07/27/1955,"Dodsland, Saskatchewan",Canada,198,14,52,66,325
"Hofford, Jim",D,10/04/1964,"Sudbury, Ontario",Canada,18,0,0,0,47
"Hoffort, Bruce",G,07/30/1966,"North Battleford, Saskatchewan",Canada,9,0,0,0,2
"Hofmann, Gregory",F,11/13/1992,Neuchâtel,Switzerland,24,2,5,7,8
"Hogaboam, Bill",F,09/05/1949,"Swift Current, Saskatchewan",Canada,332,80,109,189,100
"Hoganson, Dale",D,07/08/1949,"North Battleford, Saskatchewan",Canada,343,13,77,90,186
"Hoganson, Paul",G,11/12/1949,"Toronto, Ontario",Canada,2,0,0,0,0
"Högberg, Linus",D,09/04/1998,Stockholm,Sweden,5,0,2,2,2
"Högberg, Marcus",G,11/25/1994,Örebro,Sweden,42,0,0,0,0
"Hoggan, Jeff",F,02/01/1978,"Hope, British Columbia",Canada,107,2,9,11,76
"Höglander, Nils",F,12/20/2000,Gargnäs,Sweden,116,23,22,45,40
"Höglund, Jonas",F,08/29/1972,Karlstad,Sweden,545,117,145,262,112
"Högosta, Göran",G,04/15/1954,Äppelbo,Sweden,22,0,0,0,0
"Hogue, Benoit",F,10/28/1966,"Repentigny, Quebec",Canada,863,222,321,543,877
"Holan, Milos",D,04/22/1971,Bilovec,Czech Republic,49,5,11,16,42
"Holbrook, Terry",F,07/11/1950,"Petrolia, Ontario",Canada,43,3,6,9,4
"Holden, Josh",F,01/18/1978,"Calgary, Alberta",Canada,60,5,9,14,16
"Holden, Mark",G,06/12/1957,"Weymouth, Massachusetts",United States,8,0,1,1,0
"Holden, Nick",D,05/15/1987,"St. Albert, Alberta",Canada,589,50,112,162,164
"Holik, Bobby",F,01/01/1971,Jihlava,Czech Republic,1314,326,421,747,1423
"Holl, Justin",D,01/30/1992,"Tonka Bay, Minnesota",United States,205,9,55,64,111
"Holland, Jason",D,04/30/1976,"Morinville, Alberta",Canada,81,4,5,9,36
"Holland, Jerry",F,08/25/1954,"Beaverlodge, Alberta",Canada,37,8,4,12,6
"Holland, Ken",G,11/10/1955,"Vernon, British Columbia",Canada,4,0,0,0,0
"Holland, Patrick",F,01/07/1992,"Lethbridge, Alberta",Canada,5,0,0,0,0
"Holland, Peter",F,01/14/1991,"Toronto, Ontario",Canada,266,36,49,85,112
"Holland, Robert",G,09/10/1957,"Montréal, Quebec",Canada,44,0,0,0,2
"Hollett, Flash",D,04/13/1912,"North Sydney, Nova Scotia",Canada,560,132,181,313,358
"Hollinger, Terry",D,02/24/1971,"Regina, Saskatchewan",Canada,7,0,0,0,2
"Hollingworth, Bucky",D,07/24/1933,"Montréal, Quebec",Canada,163,4,14,18,201
"Holloway, Bruce",D,06/27/1963,"Revelstoke, British Columbia",Canada,2,0,0,0,0
"Holloway, Bud",F,03/01/1988,"Wapella, Saskatchewan",Canada,1,0,0,0,0
"Hollweg, Ryan",F,04/23/1983,"Downey, California",United States,228,5,9,14,349
"Holm, Philip",D,12/08/1991,Stockholm,Sweden,1,0,0,0,0
"Holmes, Bill",F,03/09/1899,"Portage la Prairie, Manitoba",Canada,51,6,4,10,37
"Holmes, Charlie",F,09/21/1934,"Edmonton, Alberta",Canada,23,1,3,4,10
"Holmes, Hap",G,02/21/1892,"Aurora, Ontario",Canada,103,0,0,0,0
"Holmes, Louis",F,01/29/1911,"Rushall, England",United Kingdom,59,2,4,6,8
"Holmes, Warren",F,02/18/1957,"Beeton, Ontario",Canada,45,8,18,26,7
"Holmgren, Paul",F,12/02/1955,"St. Paul, Minnesota",United States,527,144,179,323,1684
"Holmqvist, Johan",G,05/24/1978,Tolfta,Sweden,99,0,4,4,6
"Holmqvist, Mikael",F,06/08/1979,Stockholm,Sweden,156,18,17,35,72
"Holmstrom, Ben",F,04/09/1987,"Colorado Springs, Colorado",United States,7,0,0,0,7
"Holmström, Tomas",F,01/23/1973,Piteå,Sweden,1026,243,287,530,769
"Holota, Johnny",F,02/25/1921,"Hamilton, Ontario",Canada,15,2,0,2,0
"Holst, Greg",F,02/21/1954,"Montréal, Quebec",Canada,11,0,0,0,0
"Holt, Chris",G,06/05/1985,"Vancouver, British Columbia",Canada,2,0,0,0,0
"Holt, Gary",F,01/01/1952,"Sarnia, Ontario",Canada,102,13,11,24,133
"Holt, Randy",D,01/15/1953,"Pembroke, Ontario",Canada,395,4,37,41,1438
"Holtby, Braden",G,09/16/1989,"Lloydminster, Saskatchewan",Canada,513,0,12,12,27
"Holtz, Alexander",F,01/23/2002,Boo,Sweden,9,0,2,2,2
"Holway, Albert",D,09/24/1902,"Belleville, Ontario",Canada,116,7,2,9,52
"Holzer, Korbinian",D,02/16/1988,Munich,Germany,206,6,21,27,139
"Holzinger, Brian",F,10/10/1972,"Parma, Ohio",United States,547,93,145,238,339
"Holøs, Jonas",D,08/27/1987,Sarpsborg,Norway,39,0,6,6,10
"Homenuke, Ron",F,01/05/1952,"Hazelton, British Columbia",Canada,1,0,0,0,0
"Honka, Julius",D,12/03/1995,Jyväskylä,Finland,87,2,11,13,28
"Hoover, Ron",F,10/28/1966,"Oakville, Ontario",Canada,18,4,0,4,31
"Hopkins, Dean",F,06/06/1959,"Cobourg, Ontario",Canada,223,23,51,74,306
"Hopkins, Larry",F,03/17/1954,"Oshawa, Ontario",Canada,60,13,16,29,26
"Horacek, Tony",F,02/03/1967,"Vancouver, British Columbia",Canada,154,10,19,29,316
"Horak, Roman",F,05/21/1991,Ceske Budejovice,Czech Republic,84,6,13,19,16
"Horava, Miloslav",D,08/14/1961,Kladno,Czech Republic,80,5,17,22,38
"Horbul, Doug",F,07/27/1952,"Nokomis, Saskatchewan",Canada,4,1,0,1,2
"Horcoff, Shawn",F,09/17/1978,"Trail, British Columbia",Canada,1008,186,325,511,624
"Hordichuk, Darcy",F,08/10/1980,"Kamsack, Saskatchewan",Canada,542,20,21,41,1140
"Hordy, Mike",D,10/10/1956,"Thunder Bay, Ontario",Canada,11,0,0,0,7
"Horeck, Pete",F,06/15/1923,"Massey, Ontario",Canada,426,106,118,224,340
"Horne, George",F,06/27/1904,"Sudbury, Ontario",Canada,54,9,3,12,34
"Horner, Red",D,05/28/1909,"Lynden, Ontario",Canada,490,42,110,152,1288
"Hörnqvist, Patric",F,01/01/1987,Sollentuna,Sweden,879,263,277,540,453
"Hornung, Larry",D,11/10/1945,"Weyburn, Saskatchewan",Canada,47,2,9,11,10
"Horton, Nathan",F,05/29/1985,"Welland, Ontario",Canada,627,203,218,421,567
"Horton, Tim",D,01/12/1930,"Cochrane, Ontario",Canada,1445,115,403,518,1611
"Horvat, Bo",F,04/05/1995,"London, Ontario",Canada,572,170,196,366,188
"Horvath, Bronco",F,03/12/1930,"Port Colborne, Ontario",Canada,434,141,185,326,313
"Hospodar, Ed",D,02/09/1959,"Bowling Green, Ohio",United States,450,17,51,68,1314
"Hossa, Marcel",F,10/12/1981,Ilava,Slovakia,237,31,30,61,106
"Hossa, Marian",F,01/12/1979,Stara Lubovna,Slovakia,1309,525,609,1134,628
"Hosták, Martin",F,11/11/1967,Hradec Kralove,Czech Republic,55,3,11,14,24
"Hotham, Greg",D,03/07/1956,"London, Ontario",Canada,230,15,74,89,139
"Houck, Paul",F,08/12/1963,"Vancouver, British Columbia",Canada,16,1,2,3,2
"Houda, Doug",D,06/03/1966,"Blairmore, Alberta",Canada,561,19,63,82,1104
"Houde, Claude",D,11/08/1947,"Drummondville, Quebec",Canada,59,3,6,9,40
"Houde, Eric",F,12/19/1976,"Montréal, Quebec",Canada,30,2,3,5,4
"Hough, Mike",F,02/06/1963,"Montréal, Quebec",Canada,707,100,156,256,675
"Houlder, Bill",D,03/11/1967,"Thunder Bay, Ontario",Canada,846,59,191,250,412
"Houle, Martin",G,02/12/1985,"Montréal, Quebec",Canada,1,0,0,0,0
"Houle, Rejean",F,10/25/1949,"Rouyn-Noranda, Quebec",Canada,634,161,247,408,395
"Houser, Michael",G,09/13/1992,"Youngstown, Ohio",United States,6,0,0,0,0
"Housley, Phil",D,03/09/1964,"St. Paul, Minnesota",United States,1495,338,894,1232,822
"Houston, Ken",F,09/15/1953,"Dresden, Ontario",Canada,570,161,167,328,624
"Howard, Jack",D,10/15/1911,"London, Ontario",Canada,2,0,0,0,0
"Howard, Jim",G,03/26/1984,"Syracuse, New York",United States,543,0,9,9,36
"Howatt, Garry",F,09/26/1952,"Grand Center, Alberta",Canada,720,112,156,268,1836
"Howden, Brett",F,03/29/1998,"Oakbank, Manitoba",Canada,225,25,44,69,65
"Howden, Quinton",F,01/21/1992,"Oakbank, Manitoba",Canada,97,10,7,17,30
"Howe, Gordie",F,03/31/1928,"Floral, Saskatchewan",Canada,1767,801,1049,1850,1685
"Howe, Mark",D,05/28/1955,"Detroit, Michigan",United States,929,197,545,742,455
"Howe, Marty",D,02/18/1954,"Detroit, Michigan",United States,197,2,29,31,99
"Howe, Syd",F,09/28/1911,"Ottawa, Ontario",Canada,700,237,292,529,214
"Howe, Vic",F,11/02/1929,"Saskatoon, Saskatchewan",Canada,33,3,4,7,10
"Howell, Harry",D,12/28/1932,"Hamilton, Ontario",Canada,1411,94,324,418,1298
"Howell, Ron",D,12/04/1935,"Hamilton, Ontario",Canada,3,0,0,0,0
"Howse, Don",F,07/28/1952,"Grand Falls, Newfoundland and Labrador",Canada,33,2,5,7,6
"Howson, Scott",F,04/09/1960,"Toronto, Ontario",Canada,18,5,3,8,4
"Hoyda, Dave",F,05/20/1957,"Edmonton, Alberta",Canada,132,6,17,23,299
"Hrdina, Jan",F,02/05/1976,Hradec Kralove,Czech Republic,513,101,196,297,341
"Hrdina, Jirí",F,01/05/1958,Prague,Czech Republic,250,45,85,130,92
"Hrechkosy, Dave",F,11/01/1951,"Winnipeg, Manitoba",Canada,140,42,24,66,41
"Hrivik, Marek",F,08/28/1991,Žilina,Slovakia,24,0,3,3,2
"Hrivnak, Jim",G,05/28/1968,"Montréal, Quebec",Canada,85,0,5,5,2
"Hrkac, Tony",F,07/07/1966,"Thunder Bay, Ontario",Canada,758,132,239,371,173
"Hronek, Filip",D,11/02/1997,Hradec Kralove,Czech Republic,245,21,97,118,128
"Hrudey, Kelly",G,01/13/1961,"Edmonton, Alberta",Canada,677,0,16,16,173
"Hrycuik, Jim",F,10/07/1949,"Rosthern, Saskatchewan",Canada,21,5,5,10,12
"Hrymnak, Steve",D,03/03/1926,"Thunder Bay, Ontario",Canada,18,2,1,3,4
"Hrynewich, Tim",F,10/02/1963,"Leamington, Ontario",Canada,55,6,8,14,82
"Huard, Bill",F,06/24/1967,"Welland, Ontario",Canada,223,16,18,34,594
"Huard, Roland",F,09/06/1902,"Ottawa, Ontario",Canada,1,1,0,1,0
"Hubácek, Petr",F,09/02/1979,Brno,Czech Republic,6,1,0,1,2
"Huber, Willie",D,01/15/1958,Strasskirchen,Germany,655,104,217,321,950
"Huberdeau, Jonathan",F,06/04/1993,"Saint-Jérôme, Quebec",Canada,671,198,415,613,341
"Hubick, Greg",D,11/12/1951,"Strasbourg, Saskatchewan",Canada,77,6,9,15,10
"Huck, Fran",F,12/04/1945,"Regina, Saskatchewan",Canada,94,24,30,54,38
"Hucul, Fred",D,12/04/1931,"Tubrose, Saskatchewan",Canada,162,11,30,41,113
"Huddy, Charlie",D,06/02/1959,"Oshawa, Ontario",Canada,1017,99,354,453,785
"Hudler, Jirí",F,01/04/1984,Olomouc,Czech Republic,708,164,264,428,243
"Hudon, Charles",F,06/23/1994,"Alma, Quebec",Canada,125,14,27,41,56
"Hudson, Dave",F,12/28/1949,"St. Thomas, Ontario",Canada,409,59,124,183,89
"Hudson, Lex",D,12/31/1955,"Winnipeg, Manitoba",Canada,2,0,0,0,0
"Hudson, Mike",F,02/06/1967,"Guelph, Ontario",Canada,416,49,87,136,414
"Hudson, Ron",F,07/14/1911,"Calgary, Alberta",Canada,33,5,2,7,2
"Huet, Cristobal",G,09/03/1975,Saint-Martin-d'Hères,France,272,0,3,3,10
"Huffman, Kerry",D,01/03/1968,"Peterborough, Ontario",Canada,401,37,108,145,361
"Huggins, Al",F,12/21/1910,"Toronto, Ontario",Canada,20,1,1,2,0
"Hughes, Albert",F,05/13/1901,"Guelph, Ontario",Canada,60,6,8,14,22
"Hughes, Brent",F,04/05/1966,"New Westminster, British Columbia",Canada,357,41,39,80,831
"Hughes, Brent",D,06/17/1943,"Bowmanville, Ontario",Canada,436,15,117,132,440
"Hughes, Cameron",F,10/09/1996,"Edmonton, Alberta",Canada,2,0,0,0,0
"Hughes, Frank",F,10/01/1949,"Fernie, British Columbia",Canada,5,0,0,0,0
"Hughes, Howie",F,04/04/1939,"St. Boniface, Manitoba",Canada,168,25,32,57,30
"Hughes, Jack",F,05/14/2001,"Orlando, Florida",United States,166,44,64,108,26
"Hughes, Jack",D,07/20/1957,"Somerville, Massachusetts",United States,46,2,5,7,104
"Hughes, James",D,05/12/1906,"Webbwood, Ontario",Canada,40,0,1,1,60
"Hughes, John",D,03/18/1954,"Charlottetown, Prince Edward Island",Canada,70,2,14,16,211
"Hughes, Pat",F,03/25/1955,"Calgary, Alberta",Canada,573,130,128,258,646
"Hughes, Quinton",D,10/14/1999,"Orlando, Florida",United States,205,19,146,165,74
"Hughes, Ryan",F,01/17/1972,"Montréal, Quebec",Canada,3,0,0,0,0
"Hulbig, Joe",F,09/29/1973,"Norwood, Massachusetts",United States,55,4,4,8,16
"Hull, Bobby",F,01/03/1939,"Point Anne, Ontario",Canada,1063,610,560,1170,634
"Hull, Brett",F,08/09/1964,"Belleville, Ontario",Canada,1269,741,650,1391,458
"Hull, Dennis",F,11/19/1944,"Point Anne, Ontario",Canada,959,303,351,654,259
"Hull, Jody",F,02/02/1969,"Petrolia, Ontario",Canada,831,124,137,261,156
"Hulse, Cale",D,11/10/1973,"Edmonton, Alberta",Canada,619,16,79,95,1000
"Huml, Ivan",F,09/06/1981,Kladno,Czech Republic,49,6,12,18,36
"Hunt, Brad",D,08/24/1988,"Maple Ridge, British Columbia",Canada,241,22,54,76,40
"Hunt, Dryden",F,11/24/1995,"Cranbrook, British Columbia",Canada,165,12,28,40,90
"Hunt, Fred",F,01/17/1918,"Brantford, Ontario",Canada,59,15,14,29,6
"Hunt, Jamie",D,04/20/1984,"Calgary, Alberta",Canada,1,0,0,0,0
"Hunter, Dale",F,07/31/1960,"Petrolia, Ontario",Canada,1407,323,697,1020,3565
"Hunter, Dave",F,01/01/1958,"Petrolia, Ontario",Canada,746,133,190,323,918
"Hunter, Mark",F,11/12/1962,"Petrolia, Ontario",Canada,628,213,171,384,1426
"Hunter, Tim",F,09/10/1960,"Calgary, Alberta",Canada,815,62,76,138,3146
"Hunter, Trent",F,07/05/1980,"Red Deer, Alberta",Canada,497,101,135,236,209
"Hunwick, Matt",D,05/21/1985,"Warren, Michigan",United States,535,25,94,119,207
"Hunwick, Shawn",G,04/09/1987,"Sterling Heights, Michigan",United States,1,0,0,0,0
"Huras, Larry",D,07/08/1955,"Listowel, Ontario",Canada,2,0,0,0,0
"Hurlburt, Bob",F,05/01/1950,"Toronto, Ontario",Canada,1,0,0,0,2
"Hurlbut, Mike",D,10/07/1966,"Massena, New York",United States,29,1,8,9,20
"Hurley, Paul",D,07/12/1946,"Melrose, Massachusetts",United States,1,0,1,1,0
"Hurme, Jani",G,01/07/1975,Turku,Finland,76,0,0,0,19
"Hurst, Ron",F,05/18/1931,"Toronto, Ontario",Canada,64,9,7,16,70
"Huscroft, Jamie",D,01/09/1967,"Creston, British Columbia",Canada,352,5,33,38,1065
"Huselius, Kristian",F,11/10/1978,Österhaninge,Sweden,662,190,261,451,256
"Huska, Adam",G,05/12/1997,Zvolen,Slovakia,1,0,0,0,0
"Huska, Ryan",F,07/02/1975,"Cranbrook, British Columbia",Canada,1,0,0,0,0
"Huskins, Kent",D,05/04/1979,"Ottawa, Ontario",Canada,318,13,55,68,173
"Hussey, Matt",F,05/28/1979,"New Haven, Connecticut",United States,21,2,2,4,2
"Husso, Ville",G,02/06/1995,Helsinki,Finland,57,0,0,0,4
"Huston, Ron",F,04/08/1945,"Manitou, Manitoba",Canada,79,15,31,46,8
"Hutchinson, Andrew",D,03/24/1980,"Evanston, Illinois",United States,140,12,27,39,70
"Hutchinson, Michael",G,03/02/1990,"Barrie, Ontario",Canada,137,0,1,1,0
"Hutchinson, Ron",F,10/24/1936,"Flin Flon, Manitoba",Canada,9,0,0,0,0
"Hutchison, Dave",D,05/02/1952,"London, Ontario",Canada,584,19,97,116,1550
"Hutton, Ben",D,04/20/1993,"Prescott, Ontario",Canada,437,19,85,104,168
"Hutton, Bill",D,01/28/1910,"Calgary, Alberta",Canada,64,3,1,4,6
"Hutton, Carter",G,12/19/1985,"Thunder Bay, Ontario",Canada,235,0,5,5,16
"Hutton, Grant",D,07/25/1995,"Carmel, Indiana",United States,16,1,0,1,4
"Hyka, Tomas",F,03/23/1993,Mlada Boleslav,Czech Republic,27,2,5,7,2
"Hyland, Harry",F,01/02/1889,"Montréal, Quebec",Canada,17,14,2,16,65
"Hyman, Zach",F,06/09/1992,"Toronto, Ontario",Canada,421,113,126,239,237
"Hynes, Dave",F,04/17/1951,"Cambridge, Massachusetts",United States,22,4,0,4,2
"Hynes, Gord",D,07/22/1966,"Montréal, Quebec",Canada,52,3,9,12,22
"Hyvönen, Hannes",F,08/29/1975,Oulu,Finland,42,4,5,9,22
"Iafallo, Alex",F,12/21/1993,"Eden, New York",United States,361,71,97,168,60
"Iafrate, Al",D,03/21/1966,"Dearborn, Michigan",United States,799,152,311,463,1301
"Iggulden, Mike",F,11/09/1982,"St. Catharines, Ontario",Canada,12,1,4,5,4
"Iginla, Jarome",F,07/01/1977,"Edmonton, Alberta",Canada,1554,625,675,1300,1040
"Ignatiev, Victor",D,04/26/1970,Riga,Latvia,11,0,1,1,6
"Ihnacák, Miroslav",F,02/19/1962,Poprad,Slovakia,56,8,9,17,39
"Ihnacák, Peter",F,05/03/1957,Poprad,Slovakia,417,102,165,267,175
"Imama, Bokondji",F,08/03/1996,"Montréal, Quebec",Canada,4,1,0,1,5
"Imlach, Brent",F,11/16/1946,"Québec City, Quebec",Canada,3,0,0,0,0
"Immonen, Jarkko",F,04/19/1982,Rantasalmi,Finland,20,3,5,8,4
"Ing, Peter",G,04/28/1969,"Toronto, Ontario",Canada,74,0,3,3,6
"Ingarfield, Earl",F,10/25/1934,"Lethbridge, Alberta",Canada,746,179,226,405,225
"Ingarfield, Earl",F,01/30/1959,"Manhasset, New York",United States,39,4,4,8,22
"Inglis, Bill",F,05/11/1943,"Ottawa, Ontario",Canada,36,1,3,4,4
"Ingoldsby, Johnny",F,06/21/1924,"Toronto, Ontario",Canada,29,5,1,6,15
"Ingram, Connor",G,03/31/1997,"Imperial, Saskatchewan",Canada,3,0,0,0,0
"Ingram, Frank",F,09/17/1907,"Craven, Saskatchewan",Canada,99,24,16,40,69
"Ingram, John",F,12/19/1893,"Halifax, Nova Scotia",Canada,1,0,0,0,0
"Ingram, Ron",D,07/05/1933,"Toronto, Ontario",Canada,114,5,15,20,81
"Inness, Gary",G,05/28/1949,"Toronto, Ontario",Canada,162,0,5,5,12
"Intranuovo, Ralph",F,12/11/1973,"East York, Ontario",Canada,22,2,4,6,4
"Irbe, Arturs",G,02/02/1967,Riga,Latvia,568,0,9,9,90
"Ireland, Randy",G,04/05/1957,"Rosetown, Saskatchewan",Canada,2,0,0,0,0
"Irmen, Danny",F,09/06/1984,"Fargo, North Dakota",United States,2,0,0,0,0
"Irons, Robbie",G,11/19/1946,"Toronto, Ontario",Canada,1,0,0,0,0
"Ironstone, Joe",G,06/28/1898,"Sudbury, Ontario",Canada,2,0,0,0,0
"Irvin, Dick",F,07/19/1892,"Hamilton, Ontario",Canada,95,29,23,52,84
"Irvine, Ted",F,12/08/1944,"Winnipeg, Manitoba",Canada,724,154,177,331,657
"Irving, Leland",G,04/11/1988,"Barrhead, Alberta",Canada,13,0,1,1,0
"Irwin, Brayden",F,03/24/1987,"Toronto, Ontario",Canada,2,0,0,0,2
"Irwin, Ivan",D,03/13/1927,"Chicago, Illinois",United States,155,2,27,29,214
"Irwin, Matt",D,11/29/1987,"Brentwood Bay, British Columbia",Canada,400,23,65,88,175
"Isaksson, Ulf",F,03/19/1954,Norsunda,Sweden,50,7,15,22,10
"Isbister, Brad",F,05/07/1977,"Edmonton, Alberta",Canada,541,106,116,222,615
"Issel, Kim",F,09/25/1967,"Regina, Saskatchewan",Canada,4,0,0,0,0
"Ivanans, Raitis",F,01/03/1979,Riga,Latvia,282,12,6,18,569
"Jablonski, Pat",G,06/20/1967,"Toledo, Ohio",United States,128,0,4,4,13
"Jacina, Greg",F,05/22/1982,"Guelph, Ontario",Canada,14,0,1,1,6
"Jackman, Barret",D,03/05/1981,"Trail, British Columbia",Canada,876,29,157,186,1102
"Jackman, Richard",D,06/28/1978,"Toronto, Ontario",Canada,231,19,58,77,166
"Jackman, Tim",F,11/14/1981,"Minot, North Dakota",United States,483,32,43,75,806
"Jackson, Art",F,12/15/1915,"Toronto, Ontario",Canada,470,123,179,302,144
"Jackson, Busher",F,01/19/1911,"Toronto, Ontario",Canada,634,241,234,475,450
"Jackson, Dane",F,05/17/1970,"Castlegar, British Columbia",Canada,45,12,6,18,58
"Jackson, Don",D,09/02/1956,"Minneapolis, Minnesota",United States,315,16,52,68,640
"Jackson, Doug",G,12/12/1924,"Winnipeg, Manitoba",Canada,6,0,0,0,0
"Jackson, Harold",D,08/01/1918,"Cedar Springs, Ontario",Canada,219,17,35,52,208
"Jackson, Jeff",F,04/24/1965,"Chatham, Ontario",Canada,263,38,48,86,313
"Jackson, Jim",F,02/01/1960,"Oshawa, Ontario",Canada,112,17,30,47,20
"Jackson, John",D,05/03/1925,"Windsor, Ontario",Canada,48,2,5,7,38
"Jackson, Lloyd",F,01/07/1912,"Ottawa, Ontario",Canada,11,1,2,3,0
"Jackson, Percy",G,09/21/1907,"Canmore, Alberta",Canada,7,0,0,0,0
"Jackson, Scott",D,02/05/1987,"Salmon Arm, British Columbia",Canada,1,0,0,0,0
"Jackson, Stan",F,08/27/1898,"Parrsboro, Nova Scotia",Canada,86,9,9,18,84
"Jackson, Walter",F,06/03/1908,"Ibstock, England",United Kingdom,83,16,11,27,18
"Jacobs, Josh",D,02/15/1996,"Shelby Township, Michigan",United States,3,0,0,0,2
"Jacobs, Paul",F,03/09/1884,"Montréal, Quebec",Canada,1,0,0,0,0
"Jacobs, Tim",D,03/28/1952,"Espanola, Ontario",Canada,46,0,10,10,35
"Jacques, Jean-Francois",F,04/29/1985,"Montréal, Quebec",Canada,166,9,8,17,197
"Jaffray, Jason",F,06/30/1981,"Rimbey, Alberta",Canada,49,4,7,11,40
"Jágr, Jaromír",F,02/15/1972,Kladno,Czech Republic,1733,766,1155,1921,1167
"Jakopin, John",D,05/16/1975,"Toronto, Ontario",Canada,113,1,6,7,145
"Jaks, Pauli",G,01/25/1972,Schaffhausen,Switzerland,1,0,0,0,0
"Jalo, Risto",F,07/18/1962,Humppila,Finland,3,0,3,3,0
"Jalonen, Kari",F,01/06/1960,Oulu,Finland,37,9,6,15,4
"James, Connor",F,08/25/1982,"Calgary, Alberta",Canada,16,1,0,1,2
"James, Gerry",F,10/22/1934,"Regina, Saskatchewan",Canada,149,14,26,40,251
"James, Val",F,02/14/1957,"Ocala, Florida",United States,11,0,0,0,30
"Jamieson, James",D,03/21/1922,"Brantford, Ontario",Canada,1,0,1,1,0
"Janaszak, Steve",G,01/07/1957,"St. Paul, Minnesota",United States,3,0,0,0,0
"Jancevski, Dan",D,06/15/1981,"Windsor, Ontario",Canada,9,0,0,0,2
"Janecyk, Bob",G,05/18/1957,"Chicago, Illinois",United States,111,0,4,4,46
"Janik, Doug",D,03/26/1980,"Agawam, Massachusetts",United States,190,3,16,19,154
"Jankowski, Lou",F,06/27/1931,"Regina, Saskatchewan",Canada,131,19,18,37,15
"Jankowski, Mark",F,09/13/1994,"Hamilton, Ontario",Canada,272,42,38,80,69
"Janmark-Nylén, Mattias",F,12/08/1992,Danderyd,Sweden,420,66,92,158,107
"Janney, Craig",F,09/26/1967,"Hartford, Connecticut",United States,760,188,563,751,170
"Janssen, Cam",F,04/15/1984,"St. Louis, Missouri",United States,336,6,8,14,774
"Janssens, Mark",F,05/19/1968,"Surrey, British Columbia",Canada,711,40,73,113,1422
"Jantunen, Marko",F,02/14/1971,Lahti,Finland,3,0,0,0,0
"Jardine, Ryan",F,03/15/1980,"Ottawa, Ontario",Canada,8,0,2,2,2
"Järnkrok, Calle",F,09/25/1991,Gävle,Sweden,574,106,135,241,119
"Jaros, Christian",D,04/02/1996,Kosice,Slovakia,94,1,13,14,37
"Jarrett, Cole",F,01/04/1983,"Sault Ste. Marie, Ontario",Canada,1,0,0,0,0
"Jarrett, Doug",D,04/22/1944,"London, Ontario",Canada,775,38,182,220,631
"Jarrett, Gary",F,09/03/1942,"Toronto, Ontario",Canada,341,72,92,164,131
"Jarry, Pierre",F,03/30/1949,"Montréal, Quebec",Canada,344,88,117,205,142
"Jarry, Tristan",G,04/29/1995,"Surrey, British Columbia",Canada,159,0,8,8,18
"Järvenpää, Hannu",F,05/19/1963,Ii,Finland,114,11,26,37,81
"Järventie, Martti",D,04/04/1976,Tampere,Finland,1,0,0,0,0
"Järvi, Iiro",F,03/23/1965,Helsinki,Finland,116,18,43,61,58
"Jarvis, Doug",F,03/24/1955,"Brantford, Ontario",Canada,964,139,264,403,263
"Jarvis, James 'Bud'",F,12/07/1907,"Thunder Bay, Ontario",Canada,112,17,15,32,64
"Jarvis, Seth",F,02/01/2002,"Winnipeg, Manitoba",Canada,68,17,23,40,18
"Jarvis, Wes",F,05/30/1958,"Toronto, Ontario",Canada,237,31,55,86,98
"Jaskin, Dmitri",F,03/23/1993,Omsk,Russia,315,27,43,70,92
"Jaspers, Jason",F,04/08/1981,"Thunder Bay, Ontario",Canada,9,0,1,1,6
"Javanainen, Arto",F,04/08/1959,Pori,Finland,14,4,1,5,2
"Jay, Bob",D,11/18/1965,"Burlington, Massachusetts",United States,3,0,1,1,0
"Jeannot, Tanner",F,05/29/1997,"Oxbow, Saskatchewan",Canada,96,29,19,48,132
"Jeffrey, Dustin",F,02/27/1988,"Sarnia, Ontario",Canada,131,18,15,33,12
"Jeffrey, Larry",F,10/12/1940,"Goderich, Ontario",Canada,368,39,62,101,293
"Jelinek, Tomas",F,04/29/1962,Prague,Czech Republic,49,7,6,13,52
"Jenik, Jan",F,09/15/2000,Nymburk,Czech Republic,15,4,1,5,11
"Jenkins, Dean",F,11/21/1959,"Billerica, Massachusetts",United States,5,0,0,0,2
"Jenkins, Roger",D,11/18/1911,"Appleton, Wisconsin",United States,324,15,40,55,251
"Jenner, Boone",F,06/15/1993,"Dorchester, Ontario",Canada,589,144,140,284,331
"Jennings, Bill",F,06/28/1917,"Toronto, Ontario",Canada,108,32,34,66,45
"Jennings, Grant",D,05/05/1965,"Hudson Bay, Saskatchewan",Canada,389,14,43,57,804
"Jensen, Al",G,11/27/1958,"Hamilton, Ontario",Canada,179,0,4,4,44
"Jensen, Chris",F,10/28/1963,"Fort St. John, British Columbia",Canada,73,9,12,21,27
"Jensen, Darren",G,05/27/1960,"Creston, British Columbia",Canada,30,0,1,1,2
"Jensen, David",F,08/19/1965,"Newton, Massachusetts",United States,69,9,13,22,22
"Jensen, David",D,05/03/1961,"Minneapolis, Minnesota",United States,18,0,2,2,11
"Jensen, Joe",F,02/06/1983,"Maple Grove, Minnesota",United States,6,1,0,1,2
"Jensen, Nick",D,09/21/1990,"Rogers, Minnesota",United States,407,13,78,91,108
"Jensen, Nicklas",F,03/06/1993,Herning,Denmark,31,3,3,6,10
"Jensen, Steve",F,04/14/1955,"Minneapolis, Minnesota",United States,438,113,107,220,318
"Jerabek, Jakub",D,05/12/1991,Plzen,Czech Republic,37,2,6,8,8
"Jeremiah, Eddie",D,11/04/1905,"Worcester, Massachusetts",United States,15,0,1,1,0
"Jerrard, Paul",F,04/20/1965,"Winnipeg, Manitoba",Canada,5,0,0,0,4
"Jerwa, Frank",F,03/15/1909,"Bankhead, Alberta",Canada,81,11,16,27,51
"Jerwa, Joe",D,01/22/1907,Krakow,Poland,234,29,58,87,311
"Jessiman, Hugh",F,03/28/1984,"New York, New York",United States,2,0,0,0,5
"Jillson, Jeff",D,07/24/1980,"North Smithfield, Rhode Island",United States,140,9,32,41,96
"Jirik, Jaroslav",F,12/10/1939,Vojnuv Mestec,Czech Republic,3,0,0,0,0
"Joanette, Rosario",F,07/27/1919,"Salaberry-de-Valleyfield, Quebec",Canada,2,0,1,1,4
"Jodzio, Rick",F,06/03/1954,"Edmonton, Alberta",Canada,70,2,8,10,71
"Joensuu, Jesse",F,10/05/1987,Pori,Finland,129,13,11,24,77
"Johannesen, Glenn",D,02/15/1962,"North Battleford, Saskatchewan",Canada,2,0,0,0,0
"Johannson, John",F,10/18/1961,"Rochester, Minnesota",United States,5,0,0,0,0
"Johansen, Bill",F,07/27/1928,"Thunder Bay, Ontario",Canada,1,0,0,0,0
"Johansen, Lucas",D,11/16/1997,"Port Moody, British Columbia",Canada,1,0,1,1,0
"Johansen, Ryan",F,07/31/1992,"Vancouver, British Columbia",Canada,787,177,350,527,480
"Johansen, Trevor",D,03/30/1957,"Thunder Bay, Ontario",Canada,286,11,46,57,282
"Johansson, Andreas",F,05/19/1973,Hofors,Sweden,377,81,88,169,190
"Johansson, Bjorn",D,01/15/1956,Örebro,Sweden,15,1,1,2,10
"Johansson, Calle",D,02/14/1967,Göteborg,Sweden,1109,119,416,535,519
"Johansson, Jonas",G,09/19/1995,Gävle,Sweden,32,0,0,0,0
"Johansson, Jonas",F,03/18/1984,Jönköping,Sweden,1,0,0,0,2
"Johansson, Magnus",D,09/04/1973,Linköping,Sweden,45,0,14,14,18
"Johansson, Marcus",F,10/06/1990,Landskrona,Sweden,753,144,263,407,112
"Johansson, Mathias",F,02/22/1974,Oskarshamn,Sweden,58,5,10,15,16
"Johansson, Roger",D,04/17/1967,Ljungby,Sweden,161,9,34,43,163
"Johns, Don",D,12/13/1937,"St. George, Ontario",Canada,153,2,21,23,74
"Johns, Stephen",D,04/18/1992,"Wampum, Pennsylvania",United States,167,15,18,33,93
"Johnson, Aaron",D,04/30/1983,"Port Hawkesbury, Nova Scotia",Canada,291,17,45,62,227
"Johnson, Adam",F,06/22/1994,"Hibbing, Minnesota",United States,13,1,3,4,2
"Johnson, Al",F,03/30/1935,"Winnipeg, Manitoba",Canada,105,21,28,49,28
"Johnson, Andreas",F,11/21/1994,Gävle,Sweden,246,48,65,113,88
"Johnson, Bob",G,11/12/1948,"Farmington, Michigan",United States,23,0,0,0,8
"Johnson, Brent",G,03/12/1977,"Farmington, Michigan",United States,309,0,10,10,52
"Johnson, Brian",F,04/01/1960,"Montréal, Quebec",Canada,3,0,0,0,5
"Johnson, Chad",G,06/10/1986,"Calgary, Alberta",Canada,192,0,3,3,0
"Johnson, Ching",D,12/07/1898,"Winnipeg, Manitoba",Canada,436,38,48,86,836
"Johnson, Craig",F,03/08/1972,"St. Paul, Minnesota",United States,557,75,98,173,260
"Johnson, Dan",F,10/01/1944,"Winnipegosis, Manitoba",Canada,120,18,19,37,24
"Johnson, Earl",F,06/28/1931,"Fort Frances, Ontario",Canada,1,0,0,0,0
"Johnson, Erik",D,03/21/1988,"Bloomington, Minnesota",United States,857,88,241,329,502
"Johnson, Greg",F,03/16/1971,"Thunder Bay, Ontario",Canada,785,145,224,369,345
"Johnson, Jack",D,01/13/1987,"Indianapolis, Indiana",United States,1024,72,240,312,571
"Johnson, Jim",F,11/07/1942,"Winnipeg, Manitoba",Canada,302,75,111,186,73
"Johnson, Jim",D,08/09/1962,"New Hope, Minnesota",United States,829,29,166,195,1197
"Johnson, Justin",F,05/05/1981,"Anchorage, Alaska",United States,2,0,0,0,7
"Johnson, Kent",F,10/18/2002,"North Vancouver, British Columbia",Canada,9,0,3,3,2
"Johnson, Luke",F,09/19/1994,"Grand Forks, North Dakota",United States,32,1,1,2,13
"Johnson, Mark",F,09/22/1957,"Minneapolis, Minnesota",United States,669,203,305,508,269
"Johnson, Matt",F,11/23/1975,"Welland, Ontario",Canada,473,23,20,43,1523
"Johnson, Mike",F,10/03/1974,"Scarborough, Ontario",Canada,661,129,246,375,315
"Johnson, Nick",F,12/24/1985,"Calgary, Alberta",Canada,113,14,23,37,52
"Johnson, Norm",F,11/27/1932,"Moose Jaw, Saskatchewan",Canada,61,5,20,25,41
"Johnson, Reese",F,07/10/1998,"Saskatoon, Saskatchewan",Canada,42,1,5,6,25
"Johnson, Ryan",F,06/14/1976,"Thunder Bay, Ontario",Canada,701,38,84,122,250
"Johnson, Terry",D,11/28/1958,"Calgary, Alberta",Canada,285,3,24,27,580
"Johnson, Tom",D,02/18/1928,"Baldur, Manitoba",Canada,978,51,213,264,960
"Johnson, Tyler",F,07/29/1990,"Spokane, Washington",United States,615,164,204,368,198
"Johnson, Virgil",D,03/04/1912,"Minneapolis, Minnesota",United States,76,1,11,12,27
"Johnsson, Kim",D,03/16/1976,Malmö,Sweden,739,67,217,284,406
"Johnston, Bernie",F,09/15/1956,"Toronto, Ontario",Canada,57,12,24,36,16
"Johnston, Ed",G,11/24/1935,"Montréal, Quebec",Canada,592,0,10,10,26
"Johnston, George",F,07/30/1920,"St. Charles, Manitoba",Canada,58,20,12,32,2
"Johnston, Greg",F,01/14/1965,"Barrie, Ontario",Canada,187,26,29,55,124
"Johnston, Jay",D,02/25/1958,"Hamilton, Ontario",Canada,8,0,0,0,13
"Johnston, Joey",F,03/03/1949,"Peterborough, Ontario",Canada,332,85,106,191,320
"Johnston, Larry",D,07/20/1943,"Kitchener, Ontario",Canada,320,9,64,73,580
"Johnston, Marshall",D,06/06/1941,"Birch Hills, Saskatchewan",Canada,250,14,52,66,58
"Johnston, Randy",D,06/02/1958,"Brampton, Ontario",Canada,4,0,0,0,4
"Johnston, Ross",F,02/18/1994,"Charlottetown, Prince Edward Island",Canada,118,9,13,22,246
"Johnston, Ryan",D,02/14/1992,"Sudbury, Ontario",Canada,10,0,0,0,4
"Johnstone, Ed",F,03/02/1954,"Brandon, Manitoba",Canada,426,122,136,258,375
"Johnstone, Ross",D,04/07/1926,"Montréal, Quebec",Canada,42,5,4,9,14
"Jokela, Mikko",D,03/04/1980,Lappeenranta,Finland,1,0,0,0,0
"Jokiharju, Henri",D,06/17/1999,Oulu,Finland,213,10,44,54,72
"Jokinen, Jussi",F,04/01/1983,Kalajoki,Finland,951,191,372,563,377
"Jokinen, Olli",F,12/05/1978,Kuopio,Finland,1231,321,429,750,1071
"Jokipakka, Jyrki",D,08/20/1991,Tampere,Finland,150,3,25,28,34
"Joliat, Aurele",F,08/29/1901,"Ottawa, Ontario",Canada,655,269,194,463,771
"Joliat, Bobby",F,04/25/1898,"Ottawa, Ontario",Canada,1,0,0,0,0
"Joly, Greg",D,05/30/1954,"Calgary, Alberta",Canada,365,21,76,97,250
"Joly, Yvan",F,02/06/1960,"Hawkesbury, Ontario",Canada,2,0,0,0,0
"Jomphe, Jean-Francois",F,12/28/1972,"Havre-Saint-Pierre, Quebec",Canada,111,10,29,39,102
"Jonathan, Stan",F,09/05/1955,"Ohsweken, Ontario",Canada,411,91,110,201,751
"Jones, Alvin 'Buck'",D,08/17/1918,"Owen Sound, Ontario",Canada,50,2,3,5,36
"Jones, Benjamin",F,02/26/1999,"Waterloo, Ontario",Canada,2,0,0,0,2
"Jones, Blair",F,09/27/1986,"Central Butte, Saskatchewan",Canada,132,7,10,17,65
"Jones, Bob",F,11/27/1945,"Espanola, Ontario",Canada,2,0,0,0,0
"Jones, Brad",F,06/26/1965,"Sterling Heights, Michigan",United States,148,25,31,56,122
"Jones, Caleb",D,06/06/1997,"Frisco, Texas",United States,144,10,24,34,40
"Jones, Connor",F,08/16/1990,"Montrose, British Columbia",Canada,4,0,0,0,2
"Jones, David",F,08/10/1984,"Guelph, Ontario",Canada,462,104,87,191,122
"Jones, Jim",D,07/27/1949,"Espanola, Ontario",Canada,2,0,0,0,0
"Jones, Jimmy",F,01/02/1953,"Woodbridge, Ontario",Canada,148,13,18,31,68
"Jones, Keith",F,11/08/1968,"Brantford, Ontario",Canada,491,117,141,258,765
"Jones, Martin",G,01/10/1990,"North Vancouver, British Columbia",Canada,396,0,4,4,4
"Jones, Matt",D,08/08/1983,"Downers Grove, Illinois",United States,106,1,10,11,63
"Jones, Max",F,02/17/1998,"Rochester, Michigan",United States,137,17,11,28,101
"Jones, Randy",D,07/23/1981,"Quispamsis, New Brunswick",Canada,365,20,85,105,185
"Jones, Ron",D,04/11/1951,"Vermilion, Alberta",Canada,54,1,4,5,33
"Jones, Ryan",F,06/14/1984,"Chatham, Ontario",Canada,334,54,46,100,181
"Jones, Seth",D,10/03/1994,"Arlington, Texas",United States,658,70,267,337,222
"Jones, Ty",F,05/24/1978,"Richland, Washington",United States,14,0,0,0,19
"Jones, Zac",D,10/18/2000,"Glen Allen, Virginia",United States,22,0,6,6,2
"Jonsson, Hans",D,08/02/1973,Örnsköldsvik,Sweden,242,10,38,48,92
"Jönsson, Jörgen",F,09/29/1972,Ängelholm,Sweden,81,12,19,31,16
"Jönsson, Kenny",D,10/06/1974,Ängelholm,Sweden,686,63,204,267,298
"Jonsson, Lars",D,01/02/1982,Borlänge,Sweden,8,0,2,2,6
"Jonsson, Tomas",D,04/12/1960,Falun,Sweden,552,85,259,344,482
"Jonsson Fjällby, Axel",F,02/10/1998,Stockholm,Sweden,23,2,2,4,4
"Jooris, Josh",F,07/14/1990,"Burlington, Ontario",Canada,213,23,32,55,87
"Jordan, Michal",D,07/17/1990,Zlin,Czech Republic,79,3,4,7,18
"Josefson, Jacob",F,03/02/1991,Stockholm,Sweden,315,20,44,64,84
"Joseph, Chris",D,09/10/1969,"Burnaby, British Columbia",Canada,510,39,112,151,567
"Joseph, Curtis",G,04/29/1967,"Keswick, Ontario",Canada,943,0,31,31,126
"Joseph, Mathieu",F,02/09/1997,"Chambly, Quebec",Canada,232,41,41,82,81
"Joseph, Pierre-Olivier",D,07/01/1999,"Laval, Quebec",Canada,20,1,4,5,8
"Joseph, Tony",F,03/01/1969,"Cornwall, Ontario",Canada,2,1,0,1,0
"Joshua, Dakota",F,05/15/1996,"Dearborn, Michigan",United States,42,4,5,9,23
"Josi, Roman",D,06/01/1990,Bern,Switzerland,760,140,402,542,300
"Joslin, Derek",D,03/17/1987,"Richmond Hill, Ontario",Canada,116,4,12,16,63
"Jost, Tyson",F,03/14/1998,"St. Albert, Alberta",Canada,342,47,62,109,120
"Joudrey, Andrew",F,07/15/1984,"Halifax, Nova Scotia",Canada,1,0,0,0,0
"Jovanovski, Ed",D,06/26/1976,"Windsor, Ontario",Canada,1128,137,363,500,1491
"Joyal, Eddie",F,05/08/1940,"Edmonton, Alberta",Canada,465,128,134,262,103
"Joyce, Bob",F,07/11/1966,"Saint John, New Brunswick",Canada,158,34,49,83,90
"Joyce, Duane",D,05/05/1965,"Pembroke, Massachusetts",United States,3,0,0,0,0
"Juckes, Bing",F,06/14/1926,"Hamiota, Manitoba",Canada,16,2,1,3,6
"Juhlin, Patrik",F,04/24/1970,Huddinge,Sweden,56,7,6,13,23
"Julien, Claude",D,04/23/1960,"Blind River, Ontario",Canada,14,0,1,1,25
"Juneau, Joe",F,01/05/1968,"Pont-Rouge, Quebec",Canada,828,156,416,572,272
"Junker, Steve",F,06/26/1972,"Castlegar, British Columbia",Canada,5,0,0,0,0
"Junkin, Joe",G,09/08/1946,"Lindsay, Ontario",Canada,1,0,0,0,0
"Junland, Jonas",D,11/15/1987,Linköping,Sweden,4,0,2,2,2
"Juolevi, Olli",D,05/05/1998,Helsinki,Finland,41,2,1,3,6
"Jurcina, Milan",D,06/07/1983,Liptovsky Mikulas,Slovakia,430,22,59,81,280
"Jurco, Tomas",F,12/28/1992,Kosice,Slovakia,221,22,31,53,64
"Jutila, Timo",D,12/24/1963,Tampere,Finland,10,1,5,6,13
"Juulsen, Noah",D,04/02/1997,"Abbotsford, British Columbia",Canada,56,2,8,10,10
"Juzda, Bill",D,10/29/1920,"Winnipeg, Manitoba",Canada,398,14,54,68,398
"Kaarela, Jari",G,08/08/1958,Tampere,Finland,5,0,0,0,2
"Kabel, Robert",F,11/11/1934,"Dauphin, Manitoba",Canada,47,5,13,18,32
"Kaberle, Frantisek",D,11/08/1973,Kladno,Czech Republic,523,29,164,193,218
"Kaberle, Tomas",D,03/02/1978,Rakovnik,Czech Republic,984,87,476,563,260
"Kachowski, Mark",F,02/20/1965,"Edmonton, Alberta",Canada,64,6,5,11,209
"Kachur, Eddie",F,04/22/1934,"Thunder Bay, Ontario",Canada,96,10,14,24,35
"Kadri, Nazem",F,10/06/1990,"London, Ontario",Canada,739,219,293,512,589
"Kaese, Trent",F,09/09/1967,"Nanaimo, British Columbia",Canada,1,0,0,0,0
"Kähkönen, Kaapo",G,08/16/1996,Helsinki,Finland,65,0,1,1,4
"Kahun, Dominik",F,07/02/1995,Planá,Czech Republic,186,34,49,83,16
"Kaigorodov, Alexei",F,07/29/1983,Chelyabinsk,Russia,6,0,1,1,0
"Kaiser, Vern",F,09/28/1926,"Preston, Ontario",Canada,50,7,5,12,33
"Kakko, Kaapo",F,02/13/2001,Turku,Finland,157,26,32,58,34
"Kalbfleish, Walter",D,12/18/1911,"New Hamburg, Ontario",Canada,36,0,4,4,32
"Kaleta, Alex",F,11/29/1919,"Canmore, Alberta",Canada,387,92,121,213,202
"Kaleta, Patrick",F,06/08/1986,"Buffalo, New York",United States,348,27,27,54,542
"Kalinin, Dmitri",D,07/22/1980,Chelyabinsk,Russia,539,36,126,162,321
"Kalinin, Sergei",F,03/17/1991,Omsk,Russia,121,10,9,19,48
"Kalinski, Jonathon",F,05/25/1987,"Bonnyville, Alberta",Canada,22,1,4,5,0
"Kaliyev, Arthur",F,06/26/2001,Tashkent,Uzbekistan,81,15,13,28,37
"Källgren, Erik",G,10/14/1996,Stockholm,Sweden,14,0,0,0,2
"Kallio, Tomi",F,01/27/1977,Turku,Finland,140,24,31,55,48
"Kallur, Anders",F,07/06/1952,Ludvika,Sweden,383,101,110,211,149
"Kalus, Petr",F,06/29/1987,Ostrava,Czech Republic,11,4,1,5,6
"Kalynuk, Wyatt",D,04/14/1997,"Brandon, Manitoba",Canada,26,4,5,9,6
"Kamenev, Vladislav",F,08/12/1996,Orsk,Russia,66,3,10,13,20
"Kamensky, Valeri",F,04/18/1966,Voskresensk,Russia,637,200,301,501,383
"Kaminski, Kevin",F,03/13/1969,"Churchbridge, Saskatchewan",Canada,139,3,10,13,528
"Kaminsky, Max",F,04/19/1913,"Niagara Falls, Ontario",Canada,130,22,34,56,38
"Kaminsky, Yan",F,07/28/1971,Penza,Russia,26,3,2,5,4
"Kämpf, David",F,01/12/1995,Jirkov,Czech Republic,317,28,56,84,74
"Kampfer, Steven",D,09/24/1988,"Ann Arbor, Michigan",United States,231,15,24,39,110
"Kampman, Rudolph",D,03/12/1914,"Kitchener, Ontario",Canada,189,14,30,44,287
"Kamppuri, Hannu",G,07/01/1957,Helsinki,Finland,13,0,1,1,2
"Kana, Tomas",F,11/29/1987,Opava,Czech Republic,6,0,2,2,2
"Kane, Boyd",F,04/18/1978,"Swift Current, Saskatchewan",Canada,31,0,3,3,39
"Kane, Evander",F,08/02/1991,"Vancouver, British Columbia",Canada,812,286,259,545,1048
"Kane, Frank 'Red'",D,01/19/1923,"Stratford, Ontario",Canada,2,0,0,0,0
"Kane, Patrick",F,11/19/1988,"Buffalo, New York",United States,1107,430,750,1180,410
"Kanko, Petr",F,02/07/1984,Pribram,Czech Republic,10,1,0,1,0
"Kannegiesser, Gordon",D,12/21/1945,"North Bay, Ontario",Canada,23,0,1,1,15
"Kannegiesser, Sheldon",D,08/15/1947,"North Bay, Ontario",Canada,366,14,67,81,292
"Kapanen, Kasperi",F,07/23/1996,Kuopio,Finland,321,63,89,152,78
"Kapanen, Niko",F,04/29/1978,Hattula,Finland,397,36,90,126,160
"Kapanen, Sami",F,06/14/1973,Vantaa,Finland,831,189,269,458,175
"Kapla, Michael",D,09/19/1994,"Eau Claire, Wisconsin",United States,5,0,0,0,0
"Kaprizov, Kirill",F,04/26/1997,Novokuznetsk,Russia,136,74,85,159,50
"Karabin, Ladislav",F,02/16/1970,Spisska Nova Ves,Slovakia,9,0,0,0,2
"Karakas, Mike",G,12/12/1911,"Aurora, Minnesota",United States,336,0,1,1,4
"Karalahti, Jere",D,03/25/1975,Helsinki,Finland,149,8,19,27,97
"Karamnov, Vitali",F,07/06/1968,Moscow,Russia,92,12,20,32,65
"Kariya, Paul",F,10/16/1974,"Vancouver, British Columbia",Canada,989,402,587,989,399
"Kariya, Steve",F,12/22/1977,"North Vancouver, British Columbia",Canada,65,9,18,27,32
"Karjalainen, Kyösti",F,06/19/1967,Gävle,Sweden,28,1,8,9,12
"Karlander, Al",F,11/05/1946,"Lac la Hache, British Columbia",Canada,212,36,56,92,70
"Karlsson, Andreas",F,08/19/1975,Ludvika,Sweden,264,16,35,51,72
"Karlsson, Erik",D,05/31/1990,Landsbro,Sweden,838,153,507,660,386
"Karlsson, Henrik",G,11/27/1983,Tumba,Sweden,26,0,0,0,0
"Karlsson, Melker",F,07/18/1990,Lycksele,Sweden,396,60,52,112,130
"Karlsson, William",F,01/08/1993,Märsta,Sweden,533,126,178,304,76
"Karlström, Fredrik",F,01/12/1998,Stockholm,Sweden,3,0,1,1,0
"Karpa, Dave",D,05/07/1971,"Regina, Saskatchewan",Canada,557,18,80,98,1374
"Karpov, Valeri",F,08/05/1971,Chelyabinsk,Russia,76,14,15,29,32
"Karpovtsev, Alexander",D,04/07/1970,Moscow,Russia,596,34,154,188,430
"Karsums, Martins",F,02/26/1986,Riga,Latvia,24,1,5,6,6
"Kasatonov, Alexei",D,10/14/1959,Saint Petersburg,Russia,383,38,122,160,326
"Kasdorf, Jason",G,05/18/1992,"Winnipeg, Manitoba",Canada,1,0,0,0,0
"Kase, David",F,01/28/1997,Kadan,Czech Republic,7,1,0,1,0
"Kase, Ondrej",F,11/08/1995,Kadan,Czech Republic,257,57,67,124,62
"Kaskisuo, Kasimir",G,10/02/1993,Vantaa,Finland,2,0,0,0,0
"Kaspar, Lukas",F,09/23/1985,Most,Czech Republic,16,2,2,4,8
"Kasparaitis, Darius",D,10/16/1972,Elektrenai,Lithuania,863,27,136,163,1379
"Kasper, Steve",F,09/28/1961,"Montréal, Quebec",Canada,821,177,291,468,554
"Kassian, Matt",F,10/28/1986,"Edmonton, Alberta",Canada,76,4,1,5,177
"Kassian, Zack",F,01/24/1991,"Windsor, Ontario",Canada,610,90,111,201,863
"Kastelic, Ed",F,01/29/1964,"Toronto, Ontario",Canada,220,11,10,21,719
"Kastelic, Mark",F,03/11/1999,"Phoenix, Arizona",United States,16,2,2,4,14
"Kaszycki, Mike",F,02/27/1956,"Milton, Ontario",Canada,226,42,80,122,108
"Katchouk, Boris",F,06/18/1998,"Vancouver, British Columbia",Canada,59,3,4,7,39
"Katic, Mark",D,05/09/1989,"Timmins, Ontario",Canada,11,0,1,1,4
"Kaut, Martin",F,10/02/1999,Brno,Czech Republic,20,2,1,3,6
"Kavanagh, Pat",F,03/14/1979,"Ottawa, Ontario",Canada,14,2,0,2,4
"Kea, Ed",D,01/19/1948,Weesp,Netherlands,583,30,145,175,508
"Keane, Joey",D,07/02/1999,"Homer Glen, Illinois",United States,2,0,0,0,2
"Keane, Mike",F,05/29/1967,"Winnipeg, Manitoba",Canada,1161,168,302,470,881
"Keans, Doug",G,01/07/1958,"Pembroke, Ontario",Canada,210,0,6,6,53
"Kearns, Bracken",F,05/12/1981,"North Vancouver, British Columbia",Canada,35,3,3,6,22
"Kearns, Dennis",D,09/27/1945,"Kingston, Ontario",Canada,677,31,290,321,386
"Keating, Jack",F,10/09/1916,"Kitchener, Ontario",Canada,12,3,0,3,4
"Keating, John",F,02/12/1908,"Saint John, New Brunswick",Canada,35,5,5,10,19
"Keating, Mike",F,01/21/1957,"Toronto, Ontario",Canada,1,0,0,0,0
"Keats, Gordon 'Duke'",F,03/21/1895,"Montréal, Quebec",Canada,82,29,19,48,114
"Keczmer, Dan",D,05/25/1968,"Mt. Clemens, Michigan",United States,235,8,38,46,212
"Keefe, Sheldon",F,09/17/1980,"Brampton, Ontario",Canada,125,12,12,24,78
"Keeling, Melville",F,08/10/1905,"Owen Sound, Ontario",Canada,525,157,64,221,341
"Keenan, Don",G,08/08/1938,"Toronto, Ontario",Canada,1,0,0,0,0
"Keenan, Larry",F,10/01/1940,"North Bay, Ontario",Canada,233,38,64,102,28
"Keeper, Brady",D,06/05/1996,"Cross Lake, Manitoba",Canada,2,0,0,0,0
"Keetley, Matt",G,04/27/1986,"Medicine Hat, Alberta",Canada,1,0,0,0,0
"Kehoe, Rick",F,07/15/1951,"Windsor, Ontario",Canada,906,371,396,767,120
"Keith, Duncan",D,07/16/1983,"Winnipeg, Manitoba",Canada,1256,106,540,646,675
"Keith, Matt",F,04/11/1983,"Edmonton, Alberta",Canada,27,2,3,5,14
"Kekäläinen, Jarmo",F,07/07/1966,Tampere,Finland,55,5,8,13,28
"Kelleher, Chris",D,03/23/1975,"Cambridge, Massachusetts",United States,1,0,0,0,0
"Keller, Clayton",F,07/29/1998,"Chesterfield, Missouri",United States,360,96,160,256,122
"Keller, Ralph",D,02/06/1936,"Wilkie, Saskatchewan",Canada,3,1,0,1,6
"Keller, Ryan",F,01/06/1984,"Saskatoon, Saskatchewan",Canada,6,0,0,0,0
"Kellgren, Christer",F,08/15/1958,Göteborg,Sweden,5,0,0,0,0
"Kellman, Joel",F,05/25/1994,Karlskrona,Sweden,38,4,5,9,10
"Kelly, Bob",F,06/06/1946,"Thunder Bay, Ontario",Canada,425,87,109,196,687
"Kelly, Bob",F,11/25/1950,"Oakville, Ontario",Canada,837,154,208,362,1454
"Kelly, Chris",F,11/11/1980,"Toronto, Ontario",Canada,845,123,168,291,417
"Kelly, Dave",F,09/20/1952,"Chatham, Ontario",Canada,16,2,0,2,4
"Kelly, John-Paul",F,11/15/1959,"Edmonton, Alberta",Canada,400,54,70,124,366
"Kelly, Leonard 'Red'",F,07/09/1927,"Simcoe, Ontario",Canada,1316,281,542,823,327
"Kelly, Parker",F,06/14/1999,"Camrose, Alberta",Canada,42,8,5,13,60
"Kelly, Pete",F,05/22/1913,"St. Vital, Manitoba",Canada,180,21,38,59,68
"Kelly, Regis 'Pep'",F,01/17/1914,"North Bay, Ontario",Canada,289,74,53,127,105
"Kelly, Steve",F,10/26/1976,"Vancouver, British Columbia",Canada,149,9,12,21,83
"Kemp, Kevin",D,05/03/1954,"Ottawa, Ontario",Canada,3,0,0,0,4
"Kemp, Stan 'Bud'",D,03/02/1924,"Hamilton, Ontario",Canada,1,0,0,0,2
"Kempe, Adrian",F,09/13/1996,Kramfors,Sweden,390,90,96,186,208
"Kempe, Mario",F,09/19/1988,Kramfors,Sweden,70,6,7,13,22
"Kempny, Michal",D,09/08/1990,Hodonin,Czech Republic,247,15,48,63,146
"Kemppainen, Joonas",F,04/07/1988,Kajaani,Finland,44,2,3,5,4
"Kenady, Chris",F,04/10/1973,"Mound, Minnesota",United States,7,0,2,2,0
"Kendall, Bill",F,04/01/1910,"Winnipeg, Manitoba",Canada,138,16,11,27,28
"Kenins, Ronalds",F,02/28/1991,Riga,Latvia,38,4,8,12,14
"Kennedy, Dean",D,01/18/1963,"Redvers, Saskatchewan",Canada,717,26,110,136,1118
"Kennedy, Forbes",F,08/18/1935,"Dorchester, New Brunswick",Canada,603,70,108,178,888
"Kennedy, Mike",F,04/13/1972,"Vancouver, British Columbia",Canada,145,16,36,52,112
"Kennedy, Sheldon",F,06/15/1969,"Brandon, Manitoba",Canada,310,49,58,107,233
"Kennedy, Ted",F,12/12/1925,"Port Colborne, Ontario",Canada,696,230,330,560,432
"Kennedy, Tim",F,04/30/1986,"Buffalo, New York",United States,162,15,24,39,60
"Kennedy, Tyler",F,07/15/1986,"Sault Ste. Marie, Ontario",Canada,527,89,126,215,239
"Kenny, Ernie",D,08/20/1907,"Vermilion, Alberta",Canada,10,0,0,0,8
"Keon, Dave",F,03/22/1940,"Rouyn-Noranda, Quebec",Canada,1296,396,590,986,117
"Keränen, Michael",F,01/04/1990,Stockholm,Sweden,1,0,0,0,0
"Kercs, Aleksandrs",F,03/16/1967,Arkhangelsk,Russia,5,0,0,0,2
"Kerdiles, Nicolas",F,01/11/1994,"Lewisville, Texas",United States,3,0,0,0,0
"Kerfoot, Alexander",F,08/11/1994,"Vancouver, British Columbia",Canada,360,64,123,187,130
"Kero, Tanner",F,07/24/1992,"Hancock, Michigan",United States,134,11,24,35,16
"Kerr, Alan",F,03/28/1964,"Hazelton, British Columbia",Canada,391,72,94,166,826
"Kerr, Dave",G,01/11/1910,"Toronto, Ontario",Canada,430,0,0,0,0
"Kerr, Reg",F,10/16/1957,"Oxbow, Saskatchewan",Canada,263,66,94,160,169
"Kerr, Tim",F,01/05/1960,"Windsor, Ontario",Canada,655,370,304,674,596
"Kesa, Dan",F,11/23/1971,"Vancouver, British Columbia",Canada,139,8,22,30,66
"Kesler, Ryan",F,08/31/1984,"Livonia, Michigan",United States,1001,258,315,573,920
"Kessel, Phil",F,10/02/1987,"Madison, Wisconsin",United States,1204,399,557,956,372
"Kessell, Rick",F,07/27/1949,"Toronto, Ontario",Canada,135,4,24,28,8
"Ketola, Veli-Pekka",F,03/28/1948,Pori,Finland,44,9,5,14,4
"Ketter, Kerry",D,09/20/1947,"Prince George, British Columbia",Canada,41,0,2,2,58
"Khabibulin, Nikolai",G,01/13/1973,Yekaterinburg,Russia,799,0,18,18,134
"Khaira, Jujhar",F,08/13/1994,"Surrey, British Columbia",Canada,285,27,39,66,198
"Kharin, Sergei",F,02/20/1963,Odintsovo,Russia,7,2,3,5,2
"Kharitonov, Alexander",F,03/30/1976,Moscow,Russia,71,7,15,22,12
"Khavanov, Alexander",D,01/30/1972,Moscow,Russia,348,27,75,102,233
"Khmylev, Yuri",F,08/09/1964,Moscow,Russia,263,64,88,152,133
"Khokhlachev, Alexander",F,09/09/1993,Moscow,Russia,9,0,0,0,2
"Khristich, Dmitri",F,07/23/1969,Kiev,Ukraine,811,259,337,596,422
"Khudobin, Anton",G,05/07/1986,Ust-Kamenogorsk,Kazakhstan,259,0,8,8,16
"Kidd, Ian",D,05/11/1964,"Gresham, Oregon",United States,20,4,7,11,25
"Kidd, Trevor",G,03/26/1972,"Dugald, Manitoba",Canada,387,0,13,13,36
"Kiersted, Matt",D,04/14/1998,"Elk River, Minnesota",United States,17,1,1,2,4
"Kiessling, Udo",D,05/21/1955,Crimmitschau,Germany,1,0,0,0,2
"Kilger, Chad",F,11/27/1976,"Cornwall, Ontario",Canada,714,107,111,218,363
"Killorn, Alex",F,09/14/1989,"Halifax, Nova Scotia",Canada,723,171,231,402,436
"Kilrea, Brian",F,10/21/1934,"Ottawa, Ontario",Canada,26,3,5,8,12
"Kilrea, Hec",F,06/11/1907,"Blackburn Hamlet, Ontario",Canada,633,166,130,296,452
"Kilrea, Ken",F,01/16/1919,"Ottawa, Ontario",Canada,91,16,24,40,8
"Kilrea, Wally",F,02/18/1909,"Ottawa, Ontario",Canada,325,35,58,93,91
"Kimble, Darin",F,11/22/1968,"Lucky Lake, Saskatchewan",Canada,311,23,20,43,1082
"Kindl, Jakub",D,02/10/1987,Sumperk,Czech Republic,331,16,58,74,181
"Kindopp, Bryce",F,06/14/1999,"Lloydminster, Alberta",Canada,1,0,0,0,0
"Kindrachuk, Orest",F,09/14/1950,"Nanton, Alberta",Canada,508,118,261,379,648
"King, D.J.",F,06/27/1984,"Meadow Lake, Saskatchewan",Canada,118,4,7,11,215
"King, Derek",F,02/11/1967,"Hamilton, Ontario",Canada,830,261,351,612,417
"King, Dwight",F,07/05/1989,"Meadow Lake, Saskatchewan",Canada,365,53,56,109,98
"King, Frank",F,03/07/1929,"Toronto, Ontario",Canada,10,1,0,1,2
"King, Jason",F,09/14/1981,"Corner Brook, Newfoundland and Labrador",Canada,59,12,11,23,8
"King, Kris",F,02/18/1966,"Bracebridge, Ontario",Canada,849,66,85,151,2030
"King, Scott",G,06/25/1967,"Thunder Bay, Ontario",Canada,2,0,0,0,0
"King, Steven",F,07/22/1969,"East Greenwich, Rhode Island",United States,67,17,8,25,75
"King, Wayne",F,09/04/1951,"Midland, Ontario",Canada,73,5,18,23,34
"Kinkaid, Keith",G,07/04/1989,"Farmingville, New York",United States,167,0,3,3,4
"Kinnear, Geordie",D,07/09/1973,"Simcoe, Ontario",Canada,4,0,0,0,13
"Kinrade, Geoff",F,07/25/1985,"Nelson, British Columbia",Canada,1,0,0,0,0
"Kinsella, Brian",F,02/11/1954,"Barrie, Ontario",Canada,10,0,1,1,0
"Kinsella, Ray",F,01/27/1911,"Ottawa, Ontario",Canada,14,0,0,0,0
"Kiprusoff, Marko",D,06/06/1972,Turku,Finland,51,0,10,10,12
"Kiprusoff, Miikka",G,10/26/1976,Turku,Finland,623,0,10,10,47
"Kirk, Bobby",F,08/08/1909,"Belfast, Northern Ireland",United Kingdom,39,4,8,12,14
"Kirkpatrick, Bob",F,12/01/1915,"Regina, Saskatchewan",Canada,49,12,12,24,6
"Kirton, Mark",F,02/03/1958,"Regina, Saskatchewan",Canada,266,57,56,113,121
"Kiselevich, Bogdan",D,02/14/1990,Cherepovets,Russia,32,0,8,8,12
"Kisio, Kelly",F,09/18/1959,"Peace River, Alberta",Canada,761,229,429,658,768
"Kitchen, Bill",D,02/10/1960,"Schomberg, Ontario",Canada,41,1,4,5,40
"Kitchen, Hobie",D,02/08/1904,"Toronto, Ontario",Canada,47,5,4,9,58
"Kitchen, Mike",D,02/01/1956,"Newmarket, Ontario",Canada,474,12,62,74,370
"Kiviranta, Joel",F,03/23/1996,Vantaa,Finland,93,8,11,19,20
"Kivlenieks, Matiss",G,08/26/1996,Riga,Latvia,8,0,0,0,0
"Kjellberg, Patric",F,06/17/1969,Trelleborg,Sweden,394,64,96,160,84
"Klasen, Linus",F,02/19/1986,Stockholm,Sweden,4,0,0,0,0
"Klassen, Ralph",F,09/15/1955,"Humboldt, Saskatchewan",Canada,497,52,93,145,120
"Klatt, Trent",F,01/30/1971,"Robbinsdale, Minnesota",United States,782,143,200,343,307
"Klee, Ken",D,04/24/1971,"Indianapolis, Indiana",United States,934,55,140,195,880
"Klefbom, Oscar",D,07/20/1993,Karlstad,Sweden,378,34,122,156,74
"Klein, Kevin",D,12/13/1984,"Kitchener, Ontario",Canada,627,38,116,154,185
"Klein, Lloyd 'Dede'",F,01/13/1910,"Saskatoon, Saskatchewan",Canada,164,30,25,55,68
"Kleinendorst, Scot",D,01/16/1960,"Grand Rapids, Minnesota",United States,281,12,46,58,452
"Kleisinger, Terry",G,10/10/1960,"Regina, Saskatchewan",Canada,4,0,0,0,2
"Klementyev, Anton",D,03/25/1990,Togliatti,Russia,1,0,0,0,0
"Klemm, Jon",D,01/08/1970,"Cranbrook, British Columbia",Canada,773,42,100,142,436
"Klepis, Jakub",F,06/05/1984,Prague,Czech Republic,66,4,10,14,36
"Klesla, Rostislav",D,03/21/1982,Novy Jicin,Czech Republic,659,48,111,159,620
"Klíma, Petr",F,12/23/1964,Chomutov,Czech Republic,786,313,260,573,671
"Klimchuk, Morgan",F,03/02/1995,"Regina, Saskatchewan",Canada,1,0,0,0,0
"Klimovich, Sergei",F,05/08/1974,Novosibirsk,Russia,1,0,0,0,2
"Klingbeil, Ernest",F,11/03/1908,"Hancock, Michigan",United States,5,1,2,3,2
"Klingberg, Carl",F,01/28/1991,Göteborg,Sweden,12,1,0,1,4
"Klingberg, John",D,08/14/1992,Göteborg,Sweden,552,71,303,374,213
"Klinkhammer, Rob",F,08/12/1986,"Lethbridge, Alberta",Canada,193,22,21,43,64
"Kloos, Justin",F,11/30/1993,"Lakeville, Minnesota",United States,2,0,0,0,2
"Kloucek, Tomas",D,03/07/1980,Prague,Czech Republic,141,2,8,10,250
"Klukay, Joe",F,11/06/1922,"Sault Ste. Marie, Ontario",Canada,566,109,127,236,189
"Kluzak, Gord",D,03/04/1964,"Climax, Saskatchewan",Canada,299,25,98,123,541
"Klymkiw, Julian",G,07/16/1933,"Winnipeg, Manitoba",Canada,1,0,0,0,0
"Knapp, Connor",G,05/01/1990,"New York, New York",United States,2,0,1,1,0
"Knibbs, Bill",F,01/24/1942,"Toronto, Ontario",Canada,53,7,10,17,4
"Knickle, Rick",G,02/26/1960,"Chatham, New Brunswick",Canada,14,0,0,0,2
"Knight, Corban",F,09/10/1990,"Oliver, British Columbia",Canada,52,4,8,12,4
"Knight, Spencer",G,04/19/2001,"Darien, Connecticut",United States,36,0,0,0,0
"Knipscheer, Fred",F,09/03/1969,"Fort Wayne, Indiana",United States,28,6,3,9,18
"Knott, Nick",D,07/23/1920,"Kingston, Ontario",Canada,14,3,1,4,9
"Knox, Paul",F,11/23/1933,"Toronto, Ontario",Canada,1,0,0,0,0
"Knuble, Mike",F,07/04/1972,"Toronto, Ontario",Canada,1068,278,270,548,641
"Knutsen, Espen",F,01/12/1972,Oslo,Norway,207,30,81,111,105
"Knyazev, Artemi",D,01/04/2001,Kazan,Russia,1,0,0,0,0
"Knyzhov, Nikolai",D,03/20/1998,Saint Petersburg,Russia,59,2,8,10,41
"Koalska, Matt",F,05/16/1980,"St. Paul, Minnesota",United States,3,0,0,0,2
"Kobasew, Chuck",F,04/17/1982,"Vancouver, British Columbia",Canada,601,110,100,210,394
"Kochan, Dieter",G,05/11/1974,"Saskatoon, Saskatchewan",Canada,21,0,0,0,0
"Kochetkov, Pyotr",G,06/25/1999,Kazan,Russia,3,0,0,0,0
"Kocí, David",F,05/12/1981,Prague,Czech Republic,142,3,1,4,461
"Kocur, Joey",F,12/21/1964,"Kelvington, Saskatchewan",Canada,820,80,82,162,2519
"Koehler, Greg",F,02/27/1975,"Scarborough, Ontario",Canada,1,0,0,0,0
"Koekkoek, Slater",D,02/18/1994,"Winchester, Ontario",Canada,186,8,26,34,104
"Kohn, Dustin",D,02/02/1987,"Edmonton, Alberta",Canada,22,0,4,4,4
"Kohn, Ladislav",F,03/04/1975,Uherske Hradiste,Czech Republic,186,14,28,42,125
"Koistinen, Ville",D,06/17/1982,Oulu,Finland,103,8,24,32,40
"Koivisto, Tom",D,06/04/1974,Turku,Finland,22,2,4,6,10
"Koivu, Mikko",F,03/12/1983,Turku,Finland,1035,206,505,711,594
"Koivu, Saku",F,11/23/1974,Turku,Finland,1124,255,577,832,809
"Koivula, Otto",F,09/01/1998,Nokia,Finland,20,0,2,2,2
"Kolanos, Krys",F,07/27/1981,"Calgary, Alberta",Canada,149,20,22,42,94
"Kolarik, Chad",F,01/26/1986,"Abington, Pennsylvania",United States,6,0,1,1,2
"Kolarík, Pavel",D,10/24/1972,Vyskov,Czech Republic,23,0,0,0,10
"Kolesar, Keegan",F,04/08/1997,"Brandon, Manitoba",Canada,122,10,27,37,98
"Kolesar, Mark",F,01/23/1973,"Minnedosa, Manitoba",Canada,28,2,2,4,14
"Kolesnik, Vitaly",G,08/20/1979,Ust-Kamenogorsk,Kazakhstan,8,0,1,1,2
"Kolnik, Juraj",F,11/13/1980,Nitra,Slovakia,240,46,49,95,84
"Kolstad, Dean",D,06/16/1968,"Edmonton, Alberta",Canada,40,1,7,8,69
"Koltsov, Konstantin",F,04/17/1981,Minsk,Belarus,144,12,26,38,50
"Kolyachonok, Vladislav",D,05/26/2001,Minsk,Belarus,32,1,2,3,6
"Kölzig, Olaf",G,04/06/1970,Johannesburg,South Africa,719,0,17,17,107
"Komadoski, Neil",D,11/05/1951,"Winnipeg, Manitoba",Canada,502,16,76,92,632
"Komarniski, Zenith",D,08/13/1978,"Edmonton, Alberta",Canada,21,1,1,2,10
"Komarov, Leo",F,01/23/1987,Narva,Estonia,491,63,107,170,207
"Komisarek, Mike",D,01/19/1982,"West Islip, New York",United States,551,14,67,81,679
"Konan, Matthew",D,09/03/1991,"Orange, California",United States,2,0,0,0,0
"Kondratiev, Maxim",D,01/20/1983,Togliatti,Russia,40,1,2,3,24
"Konecny, Travis",F,03/11/1997,"London, Ontario",Canada,428,110,161,271,266
"Konik, George",F,05/04/1937,"Flin Flon, Manitoba",Canada,52,7,8,15,26
"Konopka, Zenon",F,01/02/1981,"Niagara Falls, Ontario",Canada,346,12,18,30,1082
"Konowalchuk, Steve",F,11/11/1972,"Salt Lake City, Utah",United States,790,171,225,396,703
"Konroyd, Steve",D,02/10/1961,"Scarborough, Ontario",Canada,895,41,195,236,863
"Konstantinov, Evgeny",G,03/29/1981,Kazan,Russia,2,0,0,0,2
"Konstantinov, Vladimir",D,03/19/1967,Murmansk,Russia,446,47,128,175,838
"Kontiola, Petri",F,10/04/1984,Seinäjoki,Finland,12,0,5,5,6
"Kontos, Chris",F,12/10/1963,"Toronto, Ontario",Canada,230,54,69,123,103
"Kopak, Russ",F,04/26/1924,"Edmonton, Alberta",Canada,24,7,9,16,0
"Kopecky, Tomas",F,02/05/1982,Ilava,Slovakia,578,68,106,174,307
"Kopitar, Anze",F,08/24/1987,Jesenice,Slovenia,1210,365,702,1067,318
"Korab, Jerry",D,09/15/1948,"Sault Ste. Marie, Ontario",Canada,975,114,341,455,1629
"Korczak, Kaedan",D,01/29/2001,"Yorkton, Saskatchewan",Canada,1,0,0,0,0
"Kordic, Dan",F,04/18/1971,"Edmonton, Alberta",Canada,197,4,8,12,584
"Kordic, John",F,03/22/1965,"Edmonton, Alberta",Canada,244,17,18,35,997
"Korenar, Josef",G,01/31/1998,Pelhrimov,Czech Republic,12,0,0,0,0
"Korn, Jim",F,07/28/1957,"Hopkins, Minnesota",United States,597,66,122,188,1801
"Korney, Mike",F,09/15/1953,"Dauphin, Manitoba",Canada,77,9,10,19,59
"Korobov, Dmitri",D,03/12/1989,Navapolatsk,Belarus,3,0,1,1,2
"Korolev, Evgeny",D,07/24/1978,Moscow,Russia,42,1,4,5,20
"Korolev, Igor",F,09/06/1970,Moscow,Russia,795,119,227,346,330
"Koroll, Cliff",F,10/01/1946,"Canora, Saskatchewan",Canada,814,208,254,462,376
"Korolyuk, Alexander",F,01/15/1976,Moscow,Russia,296,62,80,142,140
"Korpikoski, Lauri",F,07/28/1986,Turku,Finland,609,86,115,201,132
"Korpisalo, Joonas",G,04/28/1994,Pori,Finland,182,0,2,2,6
"Korshkov, Yegor",F,07/10/1996,Novosibirsk,Russia,1,1,0,1,0
"Kortko, Roger",F,02/01/1963,"Hafford, Saskatchewan",Canada,79,7,17,24,28
"Koskinen, Mikko",G,07/18/1988,Vantaa,Finland,168,0,4,4,6
"Kosmachuk, Scott",F,01/24/1994,"Toronto, Ontario",Canada,8,0,3,3,2
"Kossila, Kalle",F,04/14/1993,Neuilly-sur-Seine,France,19,2,1,3,4
"Kostin, Klim",F,05/05/1999,Penza,Russia,46,5,6,11,23
"Kostitsyn, Andrei",F,02/03/1985,Navapolatsk,Belarus,398,103,119,222,181
"Kostitsyn, Sergei",F,03/20/1987,Navapolatsk,Belarus,353,67,109,176,188
"Kostka, Mike",D,11/28/1985,"Etobicoke, Ontario",Canada,85,4,17,21,39
"Kostopoulos, Tom",F,01/24/1979,"Mississauga, Ontario",Canada,630,61,96,157,723
"Kostynski, Doug",F,02/23/1963,"Castlegar, British Columbia",Canada,15,3,1,4,4
"Kotalik, Ales",F,12/23/1978,Jindrichuv Hradec,Czech Republic,542,136,148,284,348
"Kotanen, Dick",D,11/18/1925,"Thunder Bay, Ontario",Canada,1,0,0,0,0
"Kotkaniemi, Jesperi",F,07/06/2000,Pori,Finland,237,34,57,91,98
"Kotsopoulos, Chris",D,11/27/1958,"Scarborough, Ontario",Canada,479,44,109,153,827
"Kovacevic, Johnathan",D,07/12/1997,"Niagara Falls, Ontario",Canada,4,0,0,0,2
"Kovalchuk, Ilya",F,04/15/1983,Tver,Russia,926,443,433,876,544
"Kovalenko, Andrei",F,06/07/1970,Balakovo,Russia,620,173,206,379,389
"Kovalev, Alexei",F,02/24/1973,Togliatti,Russia,1316,430,599,1029,1304
"Kowal, Joe",F,02/03/1956,"Toronto, Ontario",Canada,22,0,5,5,13
"Kozak, Don",F,02/02/1952,"Saskatoon, Saskatchewan",Canada,437,96,86,182,480
"Kozak, Les",F,10/28/1940,"Dauphin, Manitoba",Canada,12,1,0,1,2
"Kozlov, Viktor",F,02/14/1975,Togliatti,Russia,897,198,339,537,248
"Kozlov, Vyacheslav",F,05/03/1972,Voskresensk,Russia,1182,356,497,853,704
"Kozun, Brandon",F,03/08/1990,"Los Angeles, California",United States,20,2,2,4,6
"Kraft, Milan",F,01/17/1980,Plzen,Czech Republic,207,41,41,82,52
"Kraft, Ryan",F,11/07/1975,"Bottineau, North Dakota",United States,7,0,1,1,0
"Kraftcheck, Steve",D,03/03/1929,"Tinturn, Ontario",Canada,156,11,18,29,83
"Krahn, Brent",G,04/02/1982,"Winnipeg, Manitoba",Canada,1,0,0,0,0
"Krajicek, Lukas",D,03/11/1983,Prostejov,Czech Republic,328,11,61,72,245
"Krake, Skip",F,10/14/1943,"North Battleford, Saskatchewan",Canada,249,23,40,63,182
"Kravchuk, Igor",D,09/13/1966,Ufa,Russia,699,64,210,274,251
"Kravets, Mikhail",F,11/12/1963,Saint Petersburg,Russia,2,0,0,0,0
"Kravtsov, Vitaly",F,12/23/1999,Vladivostok,Russia,20,2,2,4,4
"Krebs, Peyton",F,01/26/2001,"Okotoks, Alberta",Canada,61,7,16,23,22
"Kreider, Chris",F,04/30/1991,"Boxford, Massachusetts",United States,654,229,194,423,499
"Krejcí, David",F,04/28/1986,Sternberk,Czech Republic,962,215,515,730,339
"Krentz, Dale",F,12/19/1961,"Steinbach, Manitoba",Canada,30,5,3,8,9
"Kreps, Kamil",F,11/18/1984,Litomerice,Czech Republic,232,18,42,60,71
"Krestanovich, Jordan",F,06/14/1981,"Langley, British Columbia",Canada,22,0,2,2,6
"Kristek, Jaroslav",F,03/16/1980,Zlin,Czech Republic,6,0,0,0,4
"Krivokrasov, Sergei",F,04/15/1974,Angarsk,Russia,450,86,109,195,288
"Krog, Jason",F,10/09/1975,"Fernie, British Columbia",Canada,202,22,37,59,46
"Krol, Joe",F,08/13/1915,"Winnipeg, Manitoba",Canada,26,10,4,14,8
"Kromm, Richard",F,03/29/1964,"Trail, British Columbia",Canada,372,70,103,173,138
"Kron, Robert",F,02/27/1967,Brno,Czech Republic,771,144,194,338,119
"Kronwall, Niklas",D,01/12/1981,Stockholm,Sweden,953,83,349,432,564
"Kronwall, Staffan",D,09/10/1982,Järfälla,Sweden,66,1,3,4,23
"Krook, Kevin",D,04/05/1958,"Cold Lake, Alberta",Canada,3,0,0,0,2
"Kroupa, Vlastimil",D,04/27/1975,Most,Czech Republic,105,4,19,23,66
"Krug, Torey",D,04/12/1991,"Livonia, Michigan",United States,638,78,334,412,293
"Krüger, Marcus",F,05/27/1990,Stockholm,Sweden,520,38,85,123,234
"Krulicki, Jim",F,03/09/1948,"Kitchener, Ontario",Canada,41,0,3,3,6
"Krupp, Uwe",D,06/24/1965,Köln,Germany,729,69,212,281,660
"Kruppke, Gord",D,04/02/1969,"Slave Lake, Alberta",Canada,23,0,0,0,32
"Kruse, Paul",F,03/15/1970,"Merritt, British Columbia",Canada,423,38,33,71,1074
"Krushelnyski, Mike",F,04/27/1960,"Montréal, Quebec",Canada,897,241,328,569,699
"Krutov, Vladimir",F,06/01/1960,Moscow,Russia,61,11,23,34,20
"Krygier, Todd",F,10/12/1965,"Chicago Heights, Illinois",United States,543,100,143,243,533
"Kryskow, Dave",F,12/25/1951,"Edmonton, Alberta",Canada,231,33,56,89,174
"Kryzanowski, Ed",D,11/14/1925,"Fort Frances, Ontario",Canada,237,15,22,37,65
"Kuba, Filip",D,12/29/1976,Ostrava,Czech Republic,836,70,263,333,361
"Kubalik, Dominik",F,08/21/1995,Plzen,Czech Republic,202,62,54,116,50
"Kubalik, Tomas",F,05/01/1990,Plzen,Czech Republic,12,1,3,4,6
"Kubina, Pavel",D,04/15/1977,Celadna,Czech Republic,970,110,276,386,1123
"Kucera, Frantisek",D,02/03/1968,Prague,Czech Republic,465,24,95,119,251
"Kucherov, Nikita",F,06/17/1993,Maykop,Russia,562,246,370,616,283
"Kudashov, Alexei",F,07/21/1971,Elektrostal,Russia,25,1,0,1,4
"Kudelski, Bob",F,03/03/1964,"Springfield, Massachusetts",United States,442,139,102,241,218
"Kudroc, Kristián",D,05/21/1981,Michalovce,Slovakia,26,2,2,4,38
"Kuemper, Darcy",G,05/05/1990,"Saskatoon, Saskatchewan",Canada,299,0,4,4,32
"Kuffner, Ryan",F,06/12/1996,"Ottawa, Ontario",Canada,10,0,0,0,0
"Kuhlman, Karson",F,09/26/1995,"Duluth, Minnesota",United States,100,9,14,23,21
"Kuhn, Gord",F,11/19/1905,"Truro, Nova Scotia",Canada,9,1,1,2,4
"Kühnhackl, Tom",F,02/21/1992,Landshut,Germany,232,18,36,54,60
"Kukan, Dean",D,07/08/1993,Volketswil,Switzerland,153,5,25,30,46
"Kukkonen, Lasse",D,09/18/1981,Oulu,Finland,159,6,16,22,90
"Kukulowicz, Adolph",F,04/02/1933,"Winnipeg, Manitoba",Canada,4,1,0,1,0
"Kulak, Brett",D,01/06/1994,"Stony Plain, Alberta",Canada,334,15,49,64,149
"Kulak, Stu",F,03/10/1963,"Edmonton, Alberta",Canada,90,8,4,12,130
"Kulda, Arturs",D,07/25/1988,Riga,Latvia,15,0,2,2,8
"Kulemin, Nikolai",F,07/14/1986,Magnitogorsk,Russia,669,121,153,274,173
"Kuleshov, Mikhail",F,01/07/1981,Perm,Russia,3,0,0,0,0
"Kulikov, Dmitri",D,10/29/1990,Lipetsk,Russia,805,42,156,198,494
"Kullman, Arnie",F,10/09/1927,"Winnipeg, Manitoba",Canada,13,0,1,1,11
"Kullman, Ed",F,12/12/1923,"Winnipeg, Manitoba",Canada,343,56,70,126,300
"Kultanen, Jarno",D,01/08/1973,Luumäki,Finland,102,2,11,13,59
"Kumpel, Mark",F,03/07/1961,"Wakefield, Massachusetts",United States,288,38,46,84,113
"Kundratek, Tomas",D,12/26/1989,Trinec,Czech Republic,30,1,6,7,10
"Kunin, Luke",F,12/04/1997,"Chesterfield, Missouri",United States,251,46,47,93,207
"Kunitz, Chris",F,09/26/1979,"Regina, Saskatchewan",Canada,1022,268,351,619,746
"Kuntar, Les",G,07/28/1969,"Elmira, New York",United States,6,0,0,0,2
"Kuntz, Alan",F,06/04/1919,"Toronto, Ontario",Canada,45,10,12,22,12
"Kuntz, Murray",F,12/19/1945,"Ottawa, Ontario",Canada,7,1,2,3,0
"Kunyk, Cody",F,05/20/1990,"Sherwood Park, Alberta",Canada,1,0,0,0,0
"Kuokkanen, Janne",F,05/25/1998,Oulunsalo,Finland,119,14,28,42,28
"Kupari, Rasmus",F,03/15/2000,Kotka,Finland,64,6,8,14,20
"Kuraly, Sean",F,01/20/1993,"Lewiston, New York",United States,347,38,60,98,195
"Kurashev, Philipp",F,10/12/1999,Münsingen,Switzerland,121,14,23,37,24
"Kurka, Tomas",F,12/14/1981,Most,Czech Republic,17,3,2,5,2
"Kurri, Jari",F,05/18/1960,Helsinki,Finland,1251,601,797,1398,545
"Kurt, Gary",G,03/09/1947,"Kitchener, Ontario",Canada,16,0,0,0,0
"Kurtenbach, Orland",F,09/07/1936,"Cudworth, Saskatchewan",Canada,640,119,213,332,633
"Kurtz, Justin",D,01/14/1977,"Winnipeg, Manitoba",Canada,27,3,5,8,14
"Kurvers, Tom",D,09/14/1962,"Minneapolis, Minnesota",United States,659,93,328,421,350
"Kushner, Dale",F,06/13/1966,"Terrace, British Columbia",Canada,84,10,13,23,215
"Kutlak, Zdenek",D,02/13/1980,Ceske Budejovice,Czech Republic,16,1,2,3,4
"Kuznetsov, Evgeny",F,05/19/1992,Chelyabinsk,Russia,599,153,343,496,308
"Kuznetsov, Maxim",D,03/24/1977,Pavlodar,Kazakhstan,136,2,8,10,137
"Kuznik, Greg",D,06/12/1978,"Prince George, British Columbia",Canada,1,0,0,0,0
"Kuzyk, Ken",F,08/11/1953,"Toronto, Ontario",Canada,41,5,9,14,8
"Kvartalnov, Dmitri",F,03/25/1966,Voskresensk,Russia,112,42,49,91,26
"Kvasha, Oleg",F,07/26/1978,Moscow,Russia,493,81,136,217,335
"Kwiatkowski, Joel",D,03/22/1977,"Kindersley, Saskatchewan",Canada,282,16,29,45,245
"Kwong, Larry 'King'",F,06/17/1923,"Vernon, British Columbia",Canada,1,0,0,0,0
"Kyle, Bill",F,12/23/1924,"Dysart, Saskatchewan",Canada,3,0,3,3,0
"Kyle, Walter 'Gus'",D,09/11/1923,"Dysart, Saskatchewan",Canada,203,6,20,26,362
"Kylington, Oliver",D,05/19/1997,Stockholm,Sweden,168,14,33,47,40
"Kyllönen, Markku",F,02/15/1962,Joensuu,Finland,9,0,2,2,2
"Kypreos, Nick",F,06/04/1966,"Toronto, Ontario",Canada,442,46,44,90,1210
"Kyrou, Jordan",F,05/08/1998,"Toronto, Ontario",Canada,173,46,76,122,44
"Kyte, Jim",D,03/21/1964,"Ottawa, Ontario",Canada,598,17,49,66,1342
"Kytnar, Milan",F,05/19/1989,Topolcany,Slovakia,1,0,0,0,0
"L'Abbe, Moe",F,08/12/1947,"Montréal, Quebec",Canada,5,0,1,1,0
"L'Esperance, Joel",F,08/18/1995,"Brighton, Michigan",United States,33,5,0,5,10
"Laakso, Teemu",D,08/27/1987,Tuusula,Finland,17,0,0,0,10
"Laaksonen, Antti",F,10/03/1973,Tammela,Finland,483,81,87,168,152
"Labadie, Mike",F,08/17/1932,"Saint-Francois-d'Assise, Quebec",Canada,3,0,0,0,0
"Labanc, Kevin",F,12/12/1995,"Brooklyn, New York",United States,360,65,118,183,165
"LaBarbera, Jason",G,01/18/1980,"Burnaby, British Columbia",Canada,187,0,2,2,10
"LaBate, Joseph",F,04/16/1993,"Burnsville, Minnesota",United States,13,0,0,0,21
"Labatte, Neil",D,04/24/1957,"Toronto, Ontario",Canada,26,0,2,2,19
"Labbe, Jean-Francois",G,06/15/1972,"Sherbrooke, Quebec",Canada,15,0,0,0,2
"Labelle, Marc",F,12/20/1969,"Maniwaki, Quebec",Canada,9,0,0,0,46
"Labine, Leo",F,07/22/1931,"Haileybury, Ontario",Canada,643,128,193,321,728
"Labossiere, Gord",F,01/02/1940,"St. Boniface, Manitoba",Canada,215,44,62,106,71
"Labovitch, Max",F,01/18/1924,"Winnipeg, Manitoba",Canada,5,0,0,0,4
"Labraaten, Dan",F,06/09/1951,Leksand,Sweden,268,71,73,144,47
"Labre, Yvon",D,11/29/1949,"Sudbury, Ontario",Canada,371,14,87,101,788
"Labrecque, Patrick",G,03/06/1971,"Laval, Quebec",Canada,2,0,0,0,2
"Labrie, Guy",D,08/11/1920,"Saint-Charles, Quebec",Canada,42,4,9,13,16
"Labrie, Pierre-Cedric",F,06/12/1986,"Baie-Comeau, Quebec",Canada,46,2,3,5,65
"Lach, Elmer",F,01/22/1918,"Nokomis, Saskatchewan",Canada,664,215,408,623,478
"Lachance, Michel",D,04/11/1955,"Québec City, Quebec",Canada,21,0,4,4,22
"Lachance, Scott",D,10/22/1972,"Charlottesville, Virginia",United States,819,31,112,143,567
"Lacher, Blaine",G,09/05/1970,"Medicine Hat, Alberta",Canada,47,0,1,1,8
"Läck, Eddie",G,01/05/1988,Norrtälje,Sweden,144,0,2,2,2
"Lacombe, Francois",D,02/24/1948,"Lachine, Quebec",Canada,78,2,17,19,54
"Lacombe, Normand",F,10/18/1964,"Pierrefonds, Quebec",Canada,319,53,62,115,196
"Lacosta, Daniel",G,03/28/1986,"Labrador City, Newfoundland and Labrador",Canada,4,0,0,0,0
"Lacouture, Dan",F,04/18/1977,"Hyannis, Massachusetts",United States,337,20,25,45,348
"Lacroix, Albert",G,10/21/1897,"Newton, Massachusetts",United States,5,0,0,0,0
"Lacroix, Andre",F,06/05/1945,"Lauzon, Quebec",Canada,325,79,119,198,44
"Lacroix, Daniel",F,03/11/1969,"Montréal, Quebec",Canada,188,11,7,18,379
"Lacroix, Eric",F,07/15/1971,"Montréal, Quebec",Canada,472,67,70,137,361
"Lacroix, Pierre",D,04/11/1959,"Québec City, Quebec",Canada,274,24,108,132,197
"Laczynski, Tanner",F,06/01/1997,"Shorewood, Illinois",United States,6,0,0,0,0
"Ladd, Andrew",F,12/12/1985,"Maple Ridge, British Columbia",Canada,1001,256,294,550,615
"Ladouceur, Randy",D,06/30/1960,"Brockville, Ontario",Canada,930,30,126,156,1322
"LaDue, Paul",D,09/06/1992,"Grand Forks, North Dakota",United States,70,5,13,18,22
"Lafayette, Nathan",F,02/17/1973,"New Westminster, British Columbia",Canada,187,17,20,37,103
"Laferriere, Rick",G,01/03/1961,"Hawkesbury, Ontario",Canada,1,0,0,0,0
"Lafferty, Sam",F,03/06/1995,"Hollidaysburg, Pennsylvania",United States,140,11,21,32,81
"Laflamme, Christian",D,11/24/1976,"Saint-Charles, Quebec",Canada,324,2,45,47,282
"Lafleur, Guy",F,09/20/1951,"Thurso, Quebec",Canada,1126,560,793,1353,399
"Lafleur, Rene",F,03/21/1899,"Ottawa, Ontario",Canada,1,0,0,0,0
"LaFontaine, Jack",G,01/06/1998,"Mississauga, Ontario",Canada,2,0,0,0,0
"Lafontaine, Pat",F,02/22/1965,"St. Louis, Missouri",United States,865,468,545,1013,552
"Laforce, Ernie",D,06/23/1916,"Montréal, Quebec",Canada,1,0,0,0,0
"Laforest, Bob",F,05/19/1963,"Sault Ste. Marie, Ontario",Canada,5,1,0,1,2
"Laforest, Mark",G,07/10/1962,"Welland, Ontario",Canada,103,0,6,6,65
"Laforge, Claude",F,07/01/1936,"Sorel-Tracy, Quebec",Canada,193,24,33,57,82
"Laforge, Marc",F,01/03/1968,"Sudbury, Ontario",Canada,14,0,0,0,64
"Laframboise, Pete",F,01/18/1950,"Ottawa, Ontario",Canada,227,33,55,88,70
"Lafrance, Adie",F,01/13/1912,"Chapleau, Ontario",Canada,3,0,0,0,2
"Lafrance, Leo",F,11/03/1902,"L'Isle-aux-Allumettes, Quebec",Canada,34,2,0,2,6
"Lafrenière, Alexis",F,10/11/2001,"Saint-Eustache, Quebec",Canada,135,31,21,52,45
"Lafreniere, Jason",F,12/06/1966,"St. Catharines, Ontario",Canada,146,34,53,87,22
"Lafreniere, Roger",F,07/24/1942,"Montréal, Quebec",Canada,13,0,0,0,4
"Lagace, Jean-Guy",D,02/05/1945,"L'Abord-a-Plouffe, Quebec",Canada,197,9,39,48,251
"Lagace, Maxime",G,01/12/1993,"Longueuil, Quebec",Canada,20,0,0,0,0
"Lagesson, William",D,02/22/1996,Göteborg,Sweden,60,0,7,7,22
"Laich, Brooks",F,06/23/1983,"Wawota, Saskatchewan",Canada,776,134,198,332,307
"Laidlaw, Tom",D,04/15/1958,"Brampton, Ontario",Canada,705,25,139,164,717
"Lain, Kellan",F,08/11/1989,"Oakville, Ontario",Canada,9,1,0,1,21
"Laine, Patrik",F,04/19/1998,Tampere,Finland,407,176,151,327,163
"Laing, Quintin",F,06/08/1979,"Harris, Saskatchewan",Canada,79,3,8,11,31
"Laird, Rob",F,12/29/1954,"Regina, Saskatchewan",Canada,1,0,0,0,0
"Lajeunesse, Serge",F,06/11/1950,"Montréal, Quebec",Canada,103,1,4,5,103
"Lajeunesse, Simon",G,01/22/1981,"Québec City, Quebec",Canada,1,0,0,0,0
"Lajoie, Maxime",D,11/05/1997,"Québec City, Quebec",Canada,67,7,8,15,20
"Lakovic, Sasha",F,09/07/1971,"Vancouver, British Columbia",Canada,37,0,4,4,118
"Lalande, Hec",F,11/24/1934,"North Bay, Ontario",Canada,151,21,39,60,118
"Laliberte, David",F,03/17/1986,"Saint-Jean-sur-Richelieu, Quebec",Canada,11,2,1,3,6
"Lalime, Patrick",G,07/07/1974,"Saint-Bonaventure, Quebec",Canada,444,0,6,6,58
"Lalonde, Bobby",F,03/27/1951,"Montréal, Quebec",Canada,641,124,210,334,298
"Lalonde, Newsy",F,10/31/1888,"Cornwall, Ontario",Canada,99,125,42,167,185
"Lalonde, Ron",F,10/30/1952,"Toronto, Ontario",Canada,397,45,78,123,106
"Lalonde, Shawn",D,03/10/1990,"Orleans, Ontario",Canada,1,0,0,0,0
"Lalor, Mike",D,03/08/1963,"Buffalo, New York",United States,687,17,88,105,677
"Lamb, Joe",F,06/18/1906,"Sussex, New Brunswick",Canada,443,110,101,211,595
"Lamb, Mark",F,08/03/1964,"Ponteix, Saskatchewan",Canada,403,46,100,146,291
"Lambert, Dan",D,01/12/1970,"St. Boniface, Manitoba",Canada,29,6,9,15,22
"Lambert, Denny",F,01/07/1970,"Wawa, Ontario",Canada,487,27,66,93,1391
"Lambert, Lane",F,11/18/1964,"Melfort, Saskatchewan",Canada,283,58,66,124,521
"Lambert, Yvon",F,05/20/1950,"Drummondville, Quebec",Canada,683,206,273,479,340
"Lamby, Dick",D,05/03/1955,"Auburn, Massachusetts",United States,22,0,5,5,22
"Lamirande, Jean",D,08/21/1924,"Shawinigan, Quebec",Canada,49,5,5,10,26
"Lammens, Hank",D,02/21/1966,"Brockville, Ontario",Canada,27,1,2,3,22
"Lammikko, Juho",F,01/29/1996,Noormarkku,Finland,159,11,15,26,30
"Lamothe, Marc",G,02/27/1974,"New Liskeard, Ontario",Canada,4,0,0,0,0
"Lamoureaux, Leo",D,10/01/1916,"Espanola, Ontario",Canada,236,19,79,98,179
"Lamoureux, Mitch",F,08/22/1962,"Ottawa, Ontario",Canada,73,11,9,20,59
"Lampman, Bryce",D,08/31/1982,"Rochester, Minnesota",United States,10,0,0,0,2
"Lampman, Mike",F,04/20/1950,"Hamilton, Ontario",Canada,96,17,20,37,34
"Lancien, Jack",D,06/14/1923,"Regina, Saskatchewan",Canada,63,1,5,6,35
"Lander, Anton",F,04/24/1991,Timrå,Sweden,215,10,25,35,56
"Landeskog, Gabriel",F,11/23/1992,Stockholm,Sweden,738,248,323,571,601
"Landon, Larry",F,05/04/1958,"Niagara Falls, Ontario",Canada,9,0,0,0,2
"Landry, Eric",F,01/20/1975,"Gatineau, Quebec",Canada,68,5,9,14,47
"Lane, Gord",D,03/31/1953,"Brandon, Manitoba",Canada,539,19,94,113,1228
"Lane, Myles",D,10/02/1905,"Melrose, Massachusetts",United States,71,4,1,5,53
"Lang, Robert",F,12/19/1970,Teplice,Czech Republic,989,261,442,703,422
"Langdon, Darren",F,01/08/1971,"Deer Lake, Newfoundland and Labrador",Canada,521,16,23,39,1251
"Langdon, Steve",F,12/23/1953,"Toronto, Ontario",Canada,7,0,1,1,2
"Langelle, Pete",F,11/04/1917,"Winnipeg, Manitoba",Canada,137,22,51,73,11
"Langenbrunner, Jamie",F,07/24/1975,"Cloquet, Minnesota",United States,1109,243,420,663,837
"Langevin, Chris",F,11/27/1959,"Montréal, Quebec",Canada,22,3,1,4,22
"Langevin, Dave",D,05/15/1954,"St. Paul, Minnesota",United States,513,12,107,119,530
"Langfeld, Josh",F,07/17/1977,"Coon Rapids, Minnesota",United States,143,9,23,32,60
"Langhamer, Marek",G,07/22/1994,Moravska Trebova,Czech Republic,2,0,0,0,0
"Langkow, Daymond",F,09/27/1976,"Edmonton, Alberta",Canada,1090,270,402,672,547
"Langkow, Scott",G,04/21/1975,"Sherwood Park, Alberta",Canada,20,0,0,0,0
"Langlais, Alain",F,10/09/1950,"Chicoutimi, Quebec",Canada,25,4,4,8,10
"Langlois, Albert",D,11/06/1934,"Magog, Quebec",Canada,498,21,91,112,484
"Langlois, Charlie",D,08/25/1894,"Lotbiniere, Quebec",Canada,151,22,5,27,207
"Langway, Rod",D,05/03/1957,Taipei City,Taiwan,994,51,278,329,851
"Lank, Jeff",D,03/01/1975,"Indian Head, Saskatchewan",Canada,2,0,0,0,2
"Lankinen, Kevin",G,04/28/1995,Helsinki,Finland,69,0,3,3,2
"Lanthier, Jean-Marc",F,03/27/1963,"Montréal, Quebec",Canada,105,16,16,32,29
"Lanyon, Ted",D,06/11/1939,"Winnipeg, Manitoba",Canada,5,0,0,0,4
"Lanz, Rick",D,09/16/1961,Karlovy Vary,Czech Republic,569,65,221,286,448
"Laperriere, Daniel",D,03/28/1969,"Laval, Quebec",Canada,48,2,5,7,27
"Laperriere, Ian",F,01/19/1974,"Montréal, Quebec",Canada,1083,121,215,336,1956
"Laperriere, Jacques",D,11/22/1941,"Rouyn-Noranda, Quebec",Canada,692,40,242,282,679
"Lapierre, Hendrix",F,02/09/2002,"Gatineau, Quebec",Canada,6,1,0,1,2
"Lapierre, Maxim",F,03/29/1985,"Saint-Leonard, Quebec",Canada,614,65,74,139,586
"Laplante, Darryl",F,03/28/1977,"Calgary, Alberta",Canada,35,0,6,6,10
"Lapointe, Claude",F,10/11/1968,"Lachine, Quebec",Canada,879,127,178,305,721
"Lapointe, Guy",D,03/18/1948,"Montréal, Quebec",Canada,884,171,451,622,893
"Lapointe, Martin",F,09/12/1973,"Saint-Pierre, Quebec",Canada,991,181,200,381,1417
"Lapointe, Rick",D,08/02/1955,"Victoria, British Columbia",Canada,664,44,175,219,831
"Lappin, Nick",F,11/01/1992,"Geneva, Illinois",United States,60,5,3,8,21
"Lappin, Peter",F,12/31/1965,"St. Charles, Illinois",United States,7,0,0,0,2
"Laprade, Edgar",F,10/10/1919,"Thunder Bay, Ontario",Canada,500,108,172,280,42
"Laprairie, Ben 'Bun'",D,10/20/1911,"Sault Ste. Marie, Michigan",United States,7,0,0,0,0
"Laraque, Georges",F,12/07/1976,"Montréal, Quebec",Canada,695,53,100,153,1126
"Larionov, Igor",F,12/03/1960,Voskresensk,Russia,921,169,475,644,474
"Lariviere, Garry",D,12/06/1954,"St. Catharines, Ontario",Canada,219,6,57,63,167
"Larkin, Dylan",F,07/30/1996,"Waterford Township, Michigan",United States,504,147,211,358,327
"Larman, Drew",F,05/15/1985,"Canton, Michigan",United States,26,2,1,3,4
"Larmer, Jeff",F,11/10/1962,"Peterborough, Ontario",Canada,158,37,51,88,55
"Larmer, Steve",F,06/16/1961,"Peterborough, Ontario",Canada,1006,441,571,1012,532
"Larochelle, Wildor",F,09/23/1906,"Sorel-Tracy, Quebec",Canada,475,92,75,167,213
"Larocque, Denis",D,10/05/1967,"Hawkesbury, Ontario",Canada,8,0,1,1,18
"Larocque, Mario",D,04/24/1978,"Montréal, Quebec",Canada,5,0,0,0,16
"Larocque, Michel",G,10/03/1976,Lahr,Germany,3,0,0,0,0
"Larocque, Michel",G,04/06/1952,"Hull, Quebec",Canada,312,0,18,18,18
"Larose, Chad",F,03/27/1982,"Fraser, Michigan",United States,508,85,95,180,286
"Larose, Charles",F,02/14/1901,"Ottawa, Ontario",Canada,6,0,0,0,0
"Larose, Claude",F,05/17/1955,"Saint-Jean-sur-Richelieu, Quebec",Canada,25,4,7,11,2
"Larose, Claude",F,03/02/1942,"Hearst, Ontario",Canada,944,226,257,483,889
"Larose, Cory",F,05/14/1975,"Campbellton, New Brunswick",Canada,7,0,1,1,4
"Larose, Guy",F,08/31/1967,"Hull, Quebec",Canada,70,10,9,19,63
"Larouche, Pierre",F,11/16/1955,"Taschereau, Quebec",Canada,812,395,427,822,237
"Larouche, Steve",F,04/14/1971,"Rouyn-Noranda, Quebec",Canada,26,9,9,18,10
"Larsen, Brad",F,06/28/1977,"Nakusp, British Columbia",Canada,294,19,29,48,134
"Larsen, Philip",D,12/07/1989,Esbjerg,Denmark,151,9,28,37,46
"Larson, Norm",F,10/13/1920,"Moose Jaw, Saskatchewan",Canada,89,25,18,43,12
"Larson, Reed",D,07/30/1956,"Minneapolis, Minnesota",United States,904,222,463,685,1388
"Larsson, Adam",D,11/12/1992,Skellefteå,Sweden,685,33,129,162,402
"Larsson, Jacob",D,04/29/1997,Ljungby,Sweden,165,3,21,24,46
"Larsson, Johan",F,07/25/1992,Lau,Sweden,488,53,79,132,246
"Larter, Tyler",F,03/12/1968,"Charlottetown, Prince Edward Island",Canada,1,0,0,0,0
"Lasak, Jan",G,04/10/1979,Zvolen,Slovakia,6,0,0,0,2
"Lashoff, Brian",D,07/16/1990,"Albany, New York",United States,136,2,13,15,65
"Lashoff, Matt",D,09/29/1986,"East Greenbush, New York",United States,74,1,15,16,59
"Laskoski, Gary",G,06/06/1959,"Ottawa, Ontario",Canada,59,0,1,1,6
"Látal, Jirí",D,02/02/1967,Olomouc,Czech Republic,92,12,36,48,24
"Latendresse, Guillaume",F,05/24/1987,"Sainte-Catherine, Quebec",Canada,341,87,60,147,185
"Latos, James",F,01/04/1966,"Wakaw, Saskatchewan",Canada,1,0,0,0,0
"Latreille, Phil",F,04/22/1938,"Montréal, Quebec",Canada,4,0,0,0,2
"Latta, David",F,01/03/1967,"Thunder Bay, Ontario",Canada,36,4,8,12,4
"Latta, Michael",F,05/25/1991,"St. Clements, Ontario",Canada,113,4,13,17,130
"Lauder, Marty",D,01/26/1907,"Durham, Ontario",Canada,3,0,0,0,2
"Lauen, Mike",F,02/09/1961,"Edina, Minnesota",United States,4,0,1,1,0
"Lauer, Brad",F,10/27/1966,"Humboldt, Saskatchewan",Canada,323,44,67,111,218
"Laughlin, Craig",F,09/14/1957,"Toronto, Ontario",Canada,549,136,205,341,364
"Laughton, Mike",F,02/21/1944,"Nelson, British Columbia",Canada,189,39,48,87,101
"Laughton, Scott",F,05/30/1994,"Oakville, Ontario",Canada,441,64,92,156,246
"Laukkanen, Janne",D,03/19/1970,Lahti,Finland,407,22,99,121,335
"Laurence, Don 'Red'",F,06/27/1957,"Galt, Ontario",Canada,79,15,21,36,14
"Lauridsen, Oliver",D,03/24/1989,Gentofte,Denmark,16,2,1,3,44
"Laus, Paul",D,09/26/1970,"Beamsville, Ontario",Canada,530,14,58,72,1702
"Lauzon, Jeremy",D,04/28/1997,"Val-d'Or, Quebec",Canada,142,5,13,18,152
"LaVallee, Kevin",F,09/16/1961,"Sudbury, Ontario",Canada,366,110,125,235,83
"Lavallee-Smotherman, Jordan",F,05/11/1986,"Corvallis, Oregon",United States,4,1,1,2,0
"Lavarre, Mark",F,02/21/1965,"Evanston, Illinois",United States,78,9,16,25,58
"Lavender, Brian",F,04/20/1947,"Edmonton, Alberta",Canada,184,16,26,42,174
"Lavigne, Eric",D,11/02/1972,"Victoriaville, Quebec",Canada,1,0,0,0,0
"Laviolette, Jack",D,07/27/1879,"Belleville, Ontario",Canada,18,2,1,3,6
"Laviolette, Peter",D,12/07/1964,"Norwood, Massachusetts",United States,12,0,0,0,6
"Lavoie, Dominic",D,11/21/1967,"Montréal, Quebec",Canada,38,5,8,13,32
"Law, Kirby",F,03/11/1977,"McCreary, Manitoba",Canada,9,0,1,1,4
"Lawless, Paul",F,07/02/1964,"Scarborough, Ontario",Canada,239,49,77,126,54
"Lawrence, Mark",F,01/27/1972,"Burlington, Ontario",Canada,142,18,26,44,115
"Lawson, Danny",F,10/30/1947,"Toronto, Ontario",Canada,218,28,29,57,61
"Lawson, Nathan",G,09/29/1983,"Calgary, Alberta",Canada,11,0,0,0,0
"Lawton, Brian",F,06/29/1965,"New Brunswick, New Jersey",United States,483,112,154,266,401
"Laxdal, Derek",F,02/21/1966,"St. Boniface, Manitoba",Canada,67,12,7,19,88
"Laxton, Gordie",G,03/16/1955,"Montréal, Quebec",Canada,17,0,0,0,0
"Laycoe, Hal",D,06/23/1922,"Sutherland, Saskatchewan",Canada,530,25,77,102,290
"Lazar, Curtis",F,02/02/1995,"Salmon Arm, British Columbia",Canada,404,35,55,90,90
"Lazaro, Jeff",F,03/21/1968,"Waltham, Massachusetts",United States,102,14,23,37,114
"Leach, Jamie",F,08/25/1969,"Winnipeg, Manitoba",Canada,81,11,9,20,12
"Leach, Jay",D,09/02/1979,"Syracuse, New York",United States,70,1,2,3,60
"Leach, Larry",F,06/18/1936,"Lloydminster, Saskatchewan",Canada,126,13,29,42,91
"Leach, Reggie",F,04/23/1950,"Riverton, Manitoba",Canada,934,381,285,666,387
"Leach, Steve",F,01/16/1966,"Cambridge, Massachusetts",United States,702,130,153,283,976
"Leahy, Pat",F,06/09/1979,"Brighton, Massachusetts",United States,50,4,4,8,19
"Leason, Brett",F,04/30/1999,"Calgary, Alberta",Canada,36,3,3,6,4
"Leavins, Jim",D,07/28/1960,"Dinsmore, Saskatchewan",Canada,41,2,12,14,30
"Lebda, Brett",D,01/15/1982,"Buffalo Grove, Illinois",United States,397,20,56,76,229
"Lebeau, Patrick",F,03/17/1970,"Saint-Jérôme, Quebec",Canada,15,3,2,5,6
"Lebeau, Stephan",F,02/28/1968,"Saint-Jérôme, Quebec",Canada,373,118,159,277,105
"LeBlanc, Drew",F,06/29/1989,"Duluth, Minnesota",United States,2,0,0,0,0
"Leblanc, Fern",F,01/12/1956,"Gaspé, Quebec",Canada,34,5,6,11,0
"Leblanc, Jean-Paul",F,10/20/1946,"South Durham, Quebec",Canada,153,14,30,44,87
"Leblanc, John",F,01/21/1964,"Campbellton, New Brunswick",Canada,83,26,13,39,28
"Leblanc, Louis",F,01/26/1991,"Pointe-Claire, Quebec",Canada,50,5,5,10,32
"LeBlanc, Peter",F,02/03/1988,"Hamilton, Ontario",Canada,1,0,0,0,0
"Leblanc, Ray",G,10/24/1964,"Fitchburg, Massachusetts",United States,1,0,0,0,0
"Leboutillier, Peter",F,01/11/1975,"Minnedosa, Manitoba",Canada,35,2,1,3,176
"Lebrun, Al",D,12/01/1940,"Timmins, Ontario",Canada,6,0,2,2,4
"Lecaine, Bill",F,03/11/1940,"Moose Jaw, Saskatchewan",Canada,4,0,0,0,0
"Lecavalier, Vincent",F,04/21/1980,"L'lle-Bizard, Quebec",Canada,1212,421,528,949,848
"Leclair, Jack",F,05/30/1929,"Québec City, Quebec",Canada,160,20,40,60,54
"Leclair, John",F,07/05/1969,"St. Albans, Vermont",United States,967,406,413,819,501
"Leclaire, Pascal",G,11/07/1982,"Repentigny, Quebec",Canada,173,0,4,4,8
"Leclerc, Mike",F,11/10/1976,"Winnipeg, Manitoba",Canada,341,64,94,158,288
"Leclerc, Rene",F,11/12/1947,"Vanier, Quebec",Canada,87,10,11,21,105
"Lecuyer, Doug",F,03/10/1958,"Wainwright, Alberta",Canada,126,11,31,42,178
"Leddy, Nick",D,03/20/1991,"Eden Prairie, Minnesota",United States,851,68,292,360,167
"Ledin, Per",F,09/14/1978,Luleå,Sweden,3,0,0,0,2
"Ledingham, Walt",F,10/26/1950,"Weyburn, Saskatchewan",Canada,15,0,2,2,4
"Leduc, Albert",D,11/22/1902,"Salaberry-de-Valleyfield, Quebec",Canada,383,57,36,93,622
"Leduc, Rich",F,08/24/1951,"Île Perrot, Quebec",Canada,130,28,38,66,69
"Ledyard, Grant",D,11/19/1961,"Winnipeg, Manitoba",Canada,1028,90,276,366,764
"Lee, Anders",F,07/03/1990,"Edina, Minnesota",United States,596,212,154,366,349
"Lee, Bobby",D,12/28/1911,"Verdun, Quebec",Canada,1,0,0,0,0
"Lee, Brian",D,03/26/1987,"Moorhead, Minnesota",United States,209,5,31,36,124
"Lee, Ed",F,12/17/1961,"Mount Bristol, Rhode Island",United States,2,0,0,0,5
"Lee, Peter",F,01/02/1956,"Ellesmere, England",United Kingdom,431,114,131,245,257
"Leeb, Brad",F,08/27/1979,"Red Deer, Alberta",Canada,5,0,0,0,2
"Leeb, Greg",F,05/31/1977,"Red Deer, Alberta",Canada,2,0,0,0,0
"Leeman, Gary",F,02/19/1964,"Toronto, Ontario",Canada,667,199,267,466,531
"Leetch, Brian",D,03/03/1968,"Corpus Christi, Texas",United States,1205,247,781,1028,571
"Lefebvre, Guillaume",F,05/07/1981,"Amos, Quebec",Canada,39,2,4,6,13
"Lefebvre, Patrice",F,06/28/1967,"Montréal, Quebec",Canada,3,0,0,0,2
"Lefebvre, Sylvain",D,10/14/1967,"Richmond, Quebec",Canada,945,30,154,184,674
"Lefley, Bryan",D,10/18/1948,"Grosse Isle, Manitoba",Canada,228,7,29,36,101
"Lefley, Chuck",F,01/20/1950,"Winnipeg, Manitoba",Canada,407,128,164,292,137
"Legace, Manny",G,02/04/1973,"Toronto, Ontario",Canada,365,0,9,9,12
"Leger, Roger",D,03/26/1919,"L'Annonciation, Quebec",Canada,187,18,53,71,71
"Legge, Barry",D,10/22/1954,"Winnipeg, Manitoba",Canada,107,1,11,12,144
"Legge, Randy",D,12/16/1945,"Newmarket, Ontario",Canada,12,0,2,2,2
"Legris, Claude",G,11/06/1956,"Verdun, Quebec",Canada,4,0,1,1,0
"Legwand, David",F,08/17/1980,"Detroit, Michigan",United States,1136,228,390,618,551
"Lehkonen, Artturi",F,07/04/1995,Piikkiö,Finland,412,80,78,158,112
"Lehman, Hugh",G,10/27/1885,"Pembroke, Ontario",Canada,48,0,0,0,0
"Lehman, Scott",D,01/05/1986,"Fort McMurray, Alberta",Canada,1,0,0,0,0
"Lehmann, Tommy",F,02/03/1964,Stockholm,Sweden,36,5,5,10,16
"Lehner, Robin",G,07/24/1991,Göteborg,Sweden,364,0,6,6,36
"Lehoux, Yanick",F,04/08/1982,"Montréal, Quebec",Canada,10,2,2,4,6
"Lehterä, Jori",F,12/27/1987,Helsinki,Finland,307,34,77,111,167
"Lehtinen, Jere",F,06/24/1973,Espoo,Finland,875,243,271,514,210
"Lehto, Petteri",D,03/13/1961,Turku,Finland,6,0,0,0,4
"Lehtonen, Antero",F,04/12/1954,Tampere,Finland,65,9,12,21,14
"Lehtonen, Kari",G,11/16/1983,Helsinki,Finland,649,0,28,28,42
"Lehtonen, Mikko",D,06/12/1978,Oulu,Finland,15,1,2,3,8
"Lehtonen, Mikko",D,01/16/1994,Turku,Finland,26,0,6,6,8
"Lehtonen, Mikko",F,04/01/1987,Espoo,Finland,2,0,0,0,0
"Lehvonen, Hank",D,08/26/1950,"Sarnia, Ontario",Canada,4,0,0,0,0
"Leier, Eddie",F,11/03/1927,,,16,2,1,3,2
"Leier, Taylor",F,02/15/1994,"Saskatoon, Saskatchewan",Canada,55,2,5,7,10
"Leighton, Mike",G,05/19/1981,"Petrolia, Ontario",Canada,110,0,4,4,6
"Leino, Ville",F,10/06/1983,Savonlinna,Finland,286,40,79,119,70
"Leinonen, Mikko",F,07/15/1955,Tampere,Finland,162,31,78,109,71
"Leipsic, Brendan",F,05/19/1994,"Winnipeg, Manitoba",Canada,187,16,43,59,53
"Leiter, Bob",F,03/22/1941,"Winnipeg, Manitoba",Canada,447,98,126,224,144
"Leiter, Ken",D,04/19/1961,"Detroit, Michigan",United States,143,14,36,50,62
"Leivo, Josh",F,05/26/1993,"Innisfil, Ontario",Canada,214,38,39,77,68
"Lemaire, Jacques",F,09/07/1945,"LaSalle, Quebec",Canada,853,366,469,835,217
"Lemay, Moe",F,02/18/1962,"Saskatoon, Saskatchewan",Canada,317,72,94,166,442
"Lemelin, Reggie",G,11/19/1954,"Québec City, Quebec",Canada,506,0,17,17,109
"Lemelin, Roger",D,02/06/1954,"Iroquois Falls, Ontario",Canada,36,1,2,3,27
"Lemieux, Alain",F,05/24/1961,"Montréal, Quebec",Canada,119,28,44,72,38
"Lemieux, Bob",D,12/16/1944,"Montréal, Quebec",Canada,19,0,1,1,12
"Lemieux, Brendan",F,03/15/1996,"Denver, Colorado",United States,230,31,29,60,410
"Lemieux, Claude",F,07/16/1965,"Buckingham, Quebec",Canada,1215,379,407,786,1777
"Lemieux, Jacques",D,04/08/1943,"Matane, Quebec",Canada,19,0,4,4,8
"Lemieux, Jean",D,05/31/1952,"Rouyn-Noranda, Quebec",Canada,204,23,63,86,39
"Lemieux, Jocelyn",F,11/18/1967,"Mont-Laurier, Quebec",Canada,598,80,84,164,740
"Lemieux, Mario",F,10/05/1965,"Montréal, Quebec",Canada,915,690,1033,1723,834
"Lemieux, Real",F,01/03/1945,"Victoriaville, Quebec",Canada,457,51,104,155,262
"Lemieux, Richard",F,04/19/1951,"Temiscaming, Quebec",Canada,274,39,82,121,132
"Lenardon, Tim",F,05/11/1962,"Trail, British Columbia",Canada,15,2,1,3,4
"Lenarduzzi, Mike",G,09/14/1972,"London, Ontario",Canada,4,0,0,0,0
"LeNeveu, David",G,05/23/1983,"Fernie, British Columbia",Canada,22,0,0,0,0
"Leonard, John",F,08/07/1998,"Westwood, New Jersey",United States,58,4,11,15,2
"Leopold, Jordan",D,08/03/1980,"Golden Valley, Minnesota",United States,695,67,147,214,293
"Lepine, Alfred 'Pit'",F,07/30/1901,"Sainte-Anne-de-Bellevue, Quebec",Canada,526,143,97,240,394
"Lepine, Hector",F,12/07/1897,"Sainte-Anne-de-Bellevue, Quebec",Canada,33,5,2,7,2
"Lepistö, Sami",D,10/17/1984,Espoo,Finland,176,6,29,35,137
"Lerg, Bryan",F,01/20/1986,"Livonia, Michigan",United States,8,1,0,1,0
"Lernout, Brett",D,09/24/1995,"Winnipeg, Manitoba",Canada,21,0,1,1,6
"Leroux, Francois",D,04/18/1970,"Sainte-Adele, Quebec",Canada,249,3,20,23,577
"Leroux, Gaston",F,01/09/1913,"Montréal, Quebec",Canada,2,0,0,0,0
"Leroux, Jean-Yves",F,06/24/1976,"Montréal, Quebec",Canada,220,16,22,38,146
"Leschyshyn, Curtis",D,09/21/1969,"Thompson, Manitoba",Canada,1033,47,165,212,669
"Leschyshyn, Jake",F,03/10/1999,"Raleigh, North Carolina",United States,41,2,4,6,8
"Lesieur, Art",D,09/13/1907,"Fall River, Massachusetts",United States,100,4,2,6,52
"Leskinen, Otto",D,02/06/1997,Pieksämäki,Finland,6,0,0,0,0
"Lessard, Francis",F,05/30/1979,"Montréal, Quebec",Canada,115,1,3,4,346
"Lessard, Junior",F,05/26/1980,"Saint-Joseph-de-Beauce, Quebec",Canada,27,3,1,4,23
"Lessard, Mario",G,06/25/1954,"East Broughton, Quebec",Canada,240,0,6,6,30
"Lessard, Rick",D,01/09/1968,"Timmins, Ontario",Canada,15,0,4,4,18
"Lessio, Lucas",F,01/23/1993,"Maple, Ontario",Canada,41,3,4,7,12
"Lesuk, Bill",F,11/01/1946,"Moose Jaw, Saskatchewan",Canada,388,44,63,107,368
"Leswick, Jack",F,01/01/1910,"Saskatoon, Saskatchewan",Canada,37,1,7,8,16
"Leswick, Pete",F,07/12/1916,"Saskatoon, Saskatchewan",Canada,3,1,0,1,0
"Leswick, Tony",F,03/17/1923,"Humboldt, Saskatchewan",Canada,740,165,159,324,902
"Letang, Alan",D,09/04/1975,"Renfrew, Ontario",Canada,14,0,0,0,2
"Letang, Kristopher",D,04/24/1987,"Montréal, Quebec",Canada,941,144,506,650,661
"Letestu, Mark",F,02/04/1985,"Elk Point, Alberta",Canada,567,93,117,210,90
"Letourneau-Leblond, Pierre-Luc",F,06/04/1985,"Lévis, Quebec",Canada,41,0,3,3,101
"Letowski, Trevor",F,04/05/1977,"Thunder Bay, Ontario",Canada,616,84,117,201,209
"Lettieri, Vinni",F,02/06/1995,"Excelsior, Minnesota",United States,82,7,11,18,20
"Letunov, Maxim",F,02/20/1996,Moscow,Russia,3,1,0,1,0
"Levandoski, Joe",F,03/17/1921,"Cobalt, Ontario",Canada,8,1,1,2,0
"Levasseur, Louis",G,06/16/1949,"Rouyn-Noranda, Quebec",Canada,1,0,0,0,0
"Leveille, Normand",F,01/10/1963,"Montréal, Quebec",Canada,75,17,25,42,49
"Leveque, Guy",F,12/28/1972,"Kingston, Ontario",Canada,17,2,2,4,21
"Lever, Don",F,11/14/1952,"Timmins, Ontario",Canada,1020,313,367,680,593
"Levie, Craig",D,08/17/1959,"Calgary, Alberta",Canada,183,22,53,75,177
"Levins, Scott",F,01/30/1970,"Portland, Oregon",United States,124,13,20,33,316
"Levinsky, Alex",D,02/02/1910,"Syracuse, New York",United States,367,19,49,68,307
"Levo, Tapio",D,09/24/1955,Pori,Finland,107,16,53,69,36
"Lewicki, Danny",F,03/12/1931,"Thunder Bay, Ontario",Canada,461,105,135,240,177
"Lewington, Tyler",D,12/05/1994,"Edmonton, Alberta",Canada,12,1,2,3,40
"Lewis, Dale",F,07/28/1952,"Edmonton, Alberta",Canada,8,0,0,0,0
"Lewis, Dave",D,07/03/1953,"Kindersley, Saskatchewan",Canada,1008,36,187,223,955
"Lewis, Doug",F,03/03/1921,"Winnipeg, Manitoba",Canada,3,0,0,0,0
"Lewis, Grant",D,01/20/1985,"Pittsburgh, Pennsylvania",United States,1,0,0,0,0
"Lewis, Herbie",F,04/17/1906,"Calgary, Alberta",Canada,484,147,161,308,248
"Lewis, Trevor",F,01/08/1987,"Salt Lake City, Utah",United States,810,81,108,189,185
"Ley, Rick",D,11/02/1948,"Orillia, Ontario",Canada,309,12,72,84,528
"Liambas, Michael",F,02/16/1989,"Woodbridge, Ontario",Canada,8,0,1,1,21
"Liba, Igor",F,11/04/1960,Prešov,Slovakia,37,7,18,25,36
"Libby, Jeff",D,03/01/1974,"Waterville, Maine",United States,1,0,0,0,0
"Libett, Nick",F,12/09/1945,"Stratford, Ontario",Canada,982,237,268,505,472
"Licari, Tony",F,04/09/1921,"Ottawa, Ontario",Canada,9,0,1,1,0
"Liddington, Bob",F,09/15/1948,"Calgary, Alberta",Canada,11,0,1,1,2
"Lidster, Doug",D,10/18/1960,"Kamloops, British Columbia",Canada,897,75,268,343,679
"Lidström, Nicklas",D,04/28/1970,Västerås,Sweden,1564,264,878,1142,514
"Lieuwen, Nathan",G,08/08/1991,"Abbotsford, British Columbia",Canada,7,0,0,0,0
"Liffiton, Dave",D,10/18/1984,"Windsor, Ontario",Canada,7,1,0,1,26
"Liles, John-Michael",D,11/25/1980,"Indianapolis, Indiana",United States,836,87,283,370,286
"Lilja, Andreas",D,07/13/1975,Helsingborg,Sweden,580,16,71,87,563
"Lilja, Jakob",F,07/23/1993,Limhamn,Sweden,37,2,3,5,2
"Liljegren, Timothy",D,04/30/1999,Kristianstad,Sweden,74,5,19,24,18
"Lilley, John",F,08/03/1972,"Wakefield, Massachusetts",United States,23,3,8,11,13
"Lind, Juha",F,01/02/1974,Helsinki,Finland,133,9,13,22,20
"Lind, Kole",F,10/16/1998,"Swift Current, Saskatchewan",Canada,30,2,6,8,12
"Lindbäck, Anders",G,05/03/1988,Gävle,Sweden,130,0,4,4,6
"Lindberg, Chris",F,04/16/1967,"Fort Frances, Ontario",Canada,116,17,25,42,47
"Lindberg, Oscar",F,10/29/1991,Skellefteå,Sweden,252,39,40,79,117
"Lindberg, Tobias",F,07/22/1995,Stockholm,Sweden,6,0,2,2,4
"Lindbergh, Pelle",G,05/24/1959,Stockholm,Sweden,157,0,5,5,10
"Lindblad, Matt",F,03/23/1990,"Winnetka, Illinois",United States,4,0,0,0,0
"Lindblom, Oskar",F,08/15/1996,Gävle,Sweden,263,50,47,97,63
"Lindbohm, Petteri",D,09/23/1993,Helsinki,Finland,49,2,2,4,42
"Lindbom, Johan",F,07/08/1971,Alvesta,Sweden,38,1,3,4,28
"Lindell, Esa",D,05/23/1994,Helsinki,Finland,440,36,105,141,122
"Linden, Jamie",F,07/19/1972,"Medicine Hat, Alberta",Canada,4,0,0,0,17
"Linden, Trevor",F,04/11/1970,"Medicine Hat, Alberta",Canada,1382,375,492,867,895
"Lindgren, Charlie",G,12/18/1993,"Lakeville, Minnesota",United States,29,0,0,0,2
"Lindgren, Lars",D,10/12/1952,Piteå,Sweden,394,25,113,138,325
"Lindgren, Mats",F,10/01/1974,Skellefteå,Sweden,387,54,74,128,146
"Lindgren, Perttu",F,08/26/1987,Tampere,Finland,1,0,0,0,0
"Lindgren, Ryan",D,02/11/1998,"Minneapolis, Minnesota",United States,194,6,39,45,138
"Lindholm, Anton",D,11/29/1994,Skellefteå,Sweden,66,0,5,5,16
"Lindholm, Elias",F,12/02/1994,Boden,Sweden,663,181,268,449,162
"Lindholm, Hampus",D,01/20/1994,Helsingborg,Sweden,591,57,169,226,318
"Lindholm, Mikael",F,12/19/1964,Gävle,Sweden,18,2,2,4,2
"Lindholm, Pär",F,10/05/1991,Skellefteå,Sweden,106,4,15,19,22
"Lindros, Brett",F,12/02/1975,"London, Ontario",Canada,51,2,5,7,147
"Lindros, Eric",F,02/28/1973,"London, Ontario",Canada,760,372,493,865,1398
"Lindsay, Bert",G,07/23/1881,"Garafraxa County, Ontario",Canada,20,0,0,0,0
"Lindsay, Bill",F,05/17/1971,"Fernie, British Columbia",Canada,777,83,141,224,922
"Lindsay, Ted",F,07/29/1925,"Renfrew, Ontario",Canada,1068,379,472,851,1808
"Lindström, Gustav",D,10/20/1998,Östervåla,Sweden,92,1,16,17,36
"Lindström, Joakim",F,12/05/1983,Skellefteå,Sweden,150,19,24,43,58
"Lindström, Willy",F,05/05/1951,Grums,Sweden,582,161,162,323,200
"Ling, David",F,01/09/1975,"Halifax, Nova Scotia",Canada,93,4,4,8,191
"Linglet, Charles",F,06/22/1982,"Montréal, Quebec",Canada,5,0,0,0,2
"Linseman, Ken",F,08/11/1958,"Kingston, Ontario",Canada,860,256,551,807,1725
"Lintner, Richard",D,11/15/1977,Trencín,Slovakia,112,8,12,20,54
"Lipon, J.C.",F,07/10/1993,"Regina, Saskatchewan",Canada,9,0,1,1,5
"Lipuma, Chris",D,03/23/1971,"Bridgeview, Illinois",United States,72,0,9,9,146
"Liscombe, Carl",F,05/17/1915,"Perth, Ontario",Canada,380,137,140,277,117
"Lisin, Enver",F,04/22/1986,Moscow,Russia,135,24,18,42,64
"Little, Bryan",F,11/12/1987,"Edmonton, Alberta",Canada,843,217,304,521,293
"Little, Neil",G,12/18/1971,"Medicine Hat, Alberta",Canada,2,0,0,0,10
"Littman, David",G,06/13/1967,"Cranston, Rhode Island",United States,3,0,0,0,0
"Litzenberger, Ed",F,07/15/1932,"Neudorf, Saskatchewan",Canada,619,178,238,416,275
"Liut, Mike",G,01/07/1956,"Weston, Ontario",Canada,663,0,13,13,22
"Lizotte, Blake",F,12/13/1997,"Lindstrom, Minnesota",United States,177,19,38,57,64
"Lizotte, Jon",D,11/10/1994,"Grand Forks, North Dakota",United States,1,0,0,0,2
"Loach, Lonnie",F,04/14/1968,"New Liskeard, Ontario",Canada,56,10,13,23,29
"Locas, Jacques",F,02/12/1926,"Pointe-aux-Trembles, Quebec",Canada,59,7,8,15,66
"Lochead, Bill",F,10/13/1954,"Forest, Ontario",Canada,330,69,62,131,180
"Locke, Corey",F,05/08/1984,"Toronto, Ontario",Canada,9,0,1,1,0
"Lockett, Ken",G,08/30/1947,"Toronto, Ontario",Canada,55,0,0,0,8
"Lockhart, Howard",G,03/21/1895,"North Bay, Ontario",Canada,59,0,0,0,0
"Locking, Norm",F,05/24/1911,"Owen Sound, Ontario",Canada,48,2,6,8,26
"Lockwood, William",F,06/20/1998,"Bloomfield Hills, Michigan",United States,15,0,0,0,11
"Lodin, Viktor",F,06/02/1999,Leksand,Sweden,1,0,0,0,0
"Loewen, Darcy",F,02/26/1969,"Calgary, Alberta",Canada,135,4,8,12,211
"Lofthouse, Mark",F,04/21/1957,"New Westminster, British Columbia",Canada,181,42,38,80,73
"Logan, Bob",F,02/22/1964,"Montréal, Quebec",Canada,42,10,5,15,0
"Logan, Dave",D,07/02/1954,"Montréal, Quebec",Canada,218,5,29,34,470
"Loiselle, Claude",F,05/29/1963,"Ottawa, Ontario",Canada,616,92,117,209,1149
"Lojek, Martin",D,08/19/1985,Brno,Czech Republic,5,0,1,1,0
"Loktionov, Andrei",F,05/30/1990,Voskresensk,Russia,155,22,26,48,22
"Lomakin, Andrei",F,04/03/1964,Voskresensk,Russia,215,42,62,104,92
"Lombardi, Matthew",F,03/18/1982,"Montréal, Quebec",Canada,536,101,161,262,293
"Lomberg, Ryan",F,12/09/1994,"Richmond Hill, Ontario",Canada,100,11,12,23,191
"Loney, Brian",F,08/09/1972,"Winnipeg, Manitoba",Canada,12,2,3,5,6
"Loney, Troy",F,09/21/1963,"Bow Island, Alberta",Canada,624,87,110,197,1093
"Long, Barry",D,01/31/1949,"Brantford, Ontario",Canada,280,11,68,79,250
"Lonsberry, Ross",F,02/07/1947,"Humboldt, Saskatchewan",Canada,968,256,310,566,806
"Loob, Håkan",F,07/03/1960,Visby,Sweden,450,193,236,429,189
"Loob, Peter",D,07/23/1957,Karlstad,Sweden,8,1,2,3,0
"Lööv, Viktor",D,11/16/1992,Södertälje,Sweden,4,0,2,2,0
"Lopresti, Pete",G,05/23/1954,"Virginia, Minnesota",United States,175,0,3,3,6
"Lopresti, Sam",G,01/30/1917,"Eveleth, Minnesota",United States,74,0,0,0,0
"Lorentz, Jim",F,05/01/1947,"Waterloo, Ontario",Canada,659,161,238,399,210
"Lorentz, Steven",F,04/13/1996,"Waterloo, Ontario",Canada,112,10,11,21,16
"Lorenz, Danny",G,12/12/1969,"Murrayville, British Columbia",Canada,8,0,0,0,0
"Lorimer, Bob",D,08/25/1953,"Toronto, Ontario",Canada,529,22,90,112,433
"Lorito, Matt",F,07/03/1990,"Oakville, Ontario",Canada,2,0,1,1,0
"Lorrain, Rod",F,07/26/1914,"Buckingham, Quebec",Canada,174,28,38,66,30
"Loughlin, Clem",D,11/15/1894,"Carroll, Manitoba",Canada,101,8,6,14,81
"Loughlin, Wilf",D,02/28/1896,"Carroll, Manitoba",Canada,14,0,0,0,2
"Loustel, Ron",G,03/07/1962,"Winnipeg, Manitoba",Canada,1,0,0,0,0
"Lovejoy, Ben",D,02/20/1984,"Concord, New Hampshire",United States,544,20,81,101,287
"Lovsin, Ken",D,12/03/1966,"Peace River, Alberta",Canada,1,0,0,0,0
"Low, Reed",F,06/21/1976,"Moose Jaw, Saskatchewan",Canada,256,3,16,19,725
"Low, Ron",G,06/21/1950,"Birtle, Manitoba",Canada,382,0,8,8,45
"Lowdermilk, Dwayne",D,01/09/1958,"Burnaby, British Columbia",Canada,2,0,1,1,2
"Lowe, Darren",F,10/13/1960,"Toronto, Ontario",Canada,8,1,2,3,0
"Lowe, Keegan",D,03/29/1993,"Greenwich, Connecticut",United States,4,0,0,0,10
"Lowe, Kevin",D,04/15/1959,"Lachute, Quebec",Canada,1254,84,347,431,1498
"Lowe, Norman 'Odie'",F,04/15/1928,"Winnipeg, Manitoba",Canada,3,1,1,2,0
"Lowe, Ross",D,09/21/1928,"Oshawa, Ontario",Canada,77,6,8,14,82
"Lowrey, Eddie",F,08/13/1891,"Manotick, Ontario",Canada,22,2,2,4,6
"Lowrey, Fred",F,08/12/1902,"Ottawa, Ontario",Canada,53,1,1,2,10
"Lowrey, Gerry",F,02/14/1906,"Ottawa, Ontario",Canada,211,47,48,95,166
"Lowry, Adam",F,03/29/1993,"St. Louis, Missouri",United States,539,80,88,168,287
"Lowry, Dave",F,02/14/1965,"Sudbury, Ontario",Canada,1084,164,187,351,1191
"Loyns, Lynn",F,02/22/1981,"Naicam, Saskatchewan",Canada,34,3,2,5,21
"Lozinski, Larry",G,10/16/1958,"Hudson Bay, Saskatchewan",Canada,30,0,1,1,0
"Lucas, Dan",F,02/28/1958,"Powell River, British Columbia",Canada,6,1,0,1,0
"Luce, Don",F,10/02/1948,"London, Ontario",Canada,894,225,328,553,364
"Lucic, Milan",F,06/07/1988,"Vancouver, British Columbia",Canada,1096,226,339,565,1256
"Ludvig, Jan",F,09/17/1961,Liberec,Czech Republic,314,54,87,141,418
"Ludwig, Craig",D,03/15/1961,"Rhinelander, Wisconsin",United States,1256,38,184,222,1437
"Ludzik, Steve",F,04/03/1961,"Toronto, Ontario",Canada,424,46,93,139,333
"Luff, Matt",F,05/05/1997,"Oakville, Ontario",Canada,87,13,10,23,20
"Luhning, Warren",F,07/03/1975,"Edmonton, Alberta",Canada,29,0,1,1,21
"Lukowich, Bernie",F,03/18/1952,"North Battleford, Saskatchewan",Canada,79,13,15,28,34
"Lukowich, Brad",D,08/12/1976,"Cranbrook, British Columbia",Canada,658,23,90,113,369
"Lukowich, Morris",F,06/01/1956,"Speers, Saskatchewan",Canada,582,199,219,418,584
"Luksa, Chuck",D,02/19/1954,"Toronto, Ontario",Canada,8,0,1,1,4
"Lumley, Dave",F,09/01/1954,"Toronto, Ontario",Canada,437,98,160,258,673
"Lumley, Harry",G,11/11/1926,"Owen Sound, Ontario",Canada,803,0,0,0,93
"Lumme, Jyrki",D,07/16/1966,Tampere,Finland,985,114,354,468,620
"Lund, Pentti",F,12/06/1925,Karijoki,Finland,259,44,55,99,42
"Lundberg, Brian",D,06/05/1960,"Burnaby, British Columbia",Canada,1,0,0,0,2
"Lunde, Len",F,11/13/1936,"Campbell River, British Columbia",Canada,321,39,83,122,71
"Lundell, Anton",F,10/03/2001,Espoo,Finland,65,18,26,44,18
"Lundeström, Isac",F,11/06/1999,Gällivare,Sweden,151,22,22,44,24
"Lundholm, Bengt",F,08/04/1955,Falun,Sweden,275,48,95,143,72
"Lundin, Mike",D,09/24/1984,"Burnsville, Minnesota",United States,252,4,32,36,54
"Lundkvist, Nils",D,07/27/2000,Piteå,Sweden,25,1,3,4,0
"Lundmark, Jamie",F,01/16/1981,"Edmonton, Alberta",Canada,295,40,59,99,204
"Lundqvist, Henrik",G,03/02/1982,Åre,Sweden,887,0,27,27,18
"Lundqvist, Joel",F,03/02/1982,Åre,Sweden,134,7,19,26,56
"Lundrigan, Joe",D,09/12/1948,"Corner Brook, Newfoundland and Labrador",Canada,52,2,8,10,22
"Lundström, Tord",F,03/04/1945,Kiruna,Sweden,11,1,1,2,0
"Lundy, Pat",F,05/21/1924,"Saskatoon, Saskatchewan",Canada,150,37,32,69,31
"Luoma, Mikko",D,06/22/1976,Jyväskylä,Finland,3,0,1,1,0
"Luongo, Chris",D,03/17/1967,"Detroit, Michigan",United States,218,8,23,31,176
"Luongo, Roberto",G,04/04/1979,"Montréal, Quebec",Canada,1044,0,23,23,46
"Luostarinen, Eetu",F,09/02/1998,Siilinjärvi,Finland,130,12,23,35,24
"Luoto, Joona",F,09/26/1997,Tampere,Finland,16,0,0,0,2
"Lupaschuk, Ross",D,01/19/1981,"Edmonton, Alberta",Canada,3,0,0,0,4
"Lupien, Gilles",D,04/20/1954,"Brownsburg, Quebec",Canada,226,5,25,30,416
"Lupul, Gary",F,04/20/1959,"Powell River, British Columbia",Canada,293,70,75,145,243
"Lupul, Joffrey",F,09/23/1983,"Fort Saskatchewan, Alberta",Canada,701,205,215,420,407
"Luukkonen, Ukko-Pekka",G,03/09/1999,Espoo,Finland,13,0,0,0,0
"Lyashenko, Roman",F,05/02/1979,Murmansk,Russia,139,14,9,23,55
"Lydman, Toni",D,09/25/1977,Lahti,Finland,847,36,206,242,551
"Lyle, George",F,11/24/1953,"North Vancouver, British Columbia",Canada,99,24,38,62,51
"Lynch, Doug",D,04/04/1983,"North Vancouver, British Columbia",Canada,2,0,0,0,0
"Lynch, Jack",D,05/28/1952,"Toronto, Ontario",Canada,382,24,106,130,336
"Lynn, Vic",D,01/26/1925,"Saskatoon, Saskatchewan",Canada,327,49,76,125,274
"Lyon, Alex",G,12/09/1992,"Baudette, Minnesota",United States,24,0,0,0,0
"Lyon, Steve",D,05/16/1952,"Toronto, Ontario",Canada,3,0,0,0,2
"Lyons, Ron 'Peaches'",F,02/15/1909,"Portage la Prairie, Manitoba",Canada,36,2,4,6,23
"Lysak, Brett",F,12/30/1980,"Edmonton, Alberta",Canada,2,0,0,0,2
"Lysiak, Tom",F,04/22/1953,"High Prairie, Alberta",Canada,919,292,551,843,567
"Lyubimov, Roman",F,06/01/1992,Tver,Russia,47,4,2,6,8
"Lyubushkin, Ilya",D,04/06/1994,Moscow,Russia,211,3,22,25,92
"Määttä, Olli",D,08/22/1994,Jyväskylä,Finland,534,30,106,136,134
"MacAdam, Al",F,03/16/1952,"Charlottetown, Prince Edward Island",Canada,864,240,351,591,509
"MacArthur, Clarke",F,04/06/1985,"Lloydminster, Alberta",Canada,552,133,171,304,343
"Maccelli, Matias",F,10/14/2000,Turku,Finland,23,1,5,6,4
"MacDermid, Kurtis",D,03/25/1994,"Sauble Beach, Ontario",Canada,176,8,14,22,240
"MacDermid, Lane",F,08/25/1989,"Hartford, Connecticut",United States,21,2,2,4,36
"MacDermid, Paul",F,04/14/1963,"Chesley, Ontario",Canada,690,116,142,258,1303
"MacDonald, Andrew",D,09/07/1986,"Judique, Nova Scotia",Canada,586,28,133,161,276
"MacDonald, Blair",F,11/17/1953,"Cornwall, Ontario",Canada,219,91,100,191,65
"MacDonald, Brett",D,01/05/1966,"Bothwell, Ontario",Canada,1,0,0,0,0
"MacDonald, Craig",F,04/07/1977,"Antigonish, Nova Scotia",Canada,233,11,24,35,91
"MacDonald, Doug",F,02/08/1969,"Assiniboia, Saskatchewan",Canada,11,1,0,1,2
"MacDonald, Jacob",D,02/26/1993,"Brighton, Michigan",United States,43,2,8,10,10
"MacDonald, James",F,09/06/1914,"Ottawa, Ontario",Canada,152,36,34,70,47
"MacDonald, Jason",F,04/01/1974,"Charlottetown, Prince Edward Island",Canada,4,0,0,0,19
"MacDonald, Joey",G,02/07/1980,"Pictou, Nova Scotia",Canada,133,0,1,1,8
"MacDonald, Kevin",D,02/24/1966,"Prescott, Ontario",Canada,1,0,0,0,2
"MacDonald, Lowell",F,08/30/1941,"New Glasgow, Nova Scotia",Canada,506,180,210,390,88
"MacDonald, Parker",F,06/14/1933,"Sydney, Nova Scotia",Canada,676,144,179,323,251
"MacDougall, Kim",D,08/29/1954,"Regina, Saskatchewan",Canada,1,0,0,0,0
"MacEachern, MacKenzie",F,03/09/1994,"Bloomfield Hills, Michigan",United States,115,11,8,19,55
"MacEachern, Shane",F,12/14/1967,"Charlottetown, Prince Edward Island",Canada,1,0,0,0,0
"Macenauer, Maxime",F,01/04/1989,"Laval, Quebec",Canada,29,1,3,4,18
"MacEwen, Zack",F,07/08/1996,"Stratford, Prince Edward Island",Canada,130,9,9,18,179
"Macey, Hubert",F,04/13/1921,"Big River, Saskatchewan",Canada,30,6,9,15,0
"MacGregor, Bruce",F,04/26/1941,"Edmonton, Alberta",Canada,895,213,257,470,215
"MacGregor, Randy",F,07/09/1953,"London, Ontario",Canada,2,1,1,2,2
"MacGuigan, Garth",F,02/16/1956,"Charlottetown, Prince Edward Island",Canada,5,0,1,1,2
"Machacek, Spencer",F,10/14/1988,"Lethbridge, Alberta",Canada,25,2,7,9,7
"Macias, Raymond",D,09/18/1986,"Long Beach, California",United States,8,0,1,1,2
"MacInnis, Al",D,07/11/1963,"Inverness, Nova Scotia",Canada,1416,340,934,1274,1511
"MacInnis, Ryan",F,02/14/1996,"St. Louis, Missouri",United States,27,0,1,1,0
"Macintosh, Ian",F,06/10/1927,"Selkirk, Manitoba",Canada,4,0,0,0,4
"MacIntyre, Drew",G,06/24/1983,"Charlottetown, Prince Edward Island",Canada,6,0,0,0,0
"MacIntyre, Steve",F,08/08/1980,"Brock, Saskatchewan",Canada,91,2,2,4,175
"MacIver, Don",D,05/03/1955,"Montréal, Quebec",Canada,6,0,0,0,2
"MacIver, Norm",D,09/08/1964,"Thunder Bay, Ontario",Canada,501,55,230,285,350
"MacKasey, Blair",D,12/13/1955,"Hamilton, Ontario",Canada,1,0,0,0,2
"MacKay, Calum",F,01/01/1927,"Toronto, Ontario",Canada,237,50,55,105,214
"MacKay, David",D,01/14/1919,"Edmonton, Alberta",Canada,27,3,0,3,28
"MacKay, Mickey",F,05/25/1894,"Chesley, Ontario",Canada,147,44,19,63,79
"MacKay, Murdo",F,08/08/1917,"Thunder Bay, Ontario",Canada,19,0,3,3,0
"MacKell, Fleming",F,04/30/1929,"Montréal, Quebec",Canada,666,149,220,369,565
"MacKell, Jack",D,04/12/1896,"Ottawa, Ontario",Canada,45,4,2,6,54
"MacKenzie, Aaron",D,03/07/1981,"Terrace Bay, Ontario",Canada,5,0,0,0,0
"MacKenzie, Barry",D,08/16/1941,"Toronto, Ontario",Canada,6,0,1,1,6
"MacKenzie, Bill",D,12/12/1911,"Winnipeg, Manitoba",Canada,233,11,10,21,132
"MacKenzie, Clarence",F,07/11/1909,"Cambridge, Massachusetts",United States,36,4,4,8,13
"MacKenzie, Derek",F,06/11/1981,"Sudbury, Ontario",Canada,611,51,74,125,337
"MacKenzie, Shawn",G,08/22/1962,"Bedford, Nova Scotia",Canada,6,0,0,0,0
"Mackey, Connor",D,09/12/1996,"Barrington, Illinois",United States,9,1,3,4,22
"Mackey, David",F,07/24/1966,"Richmond, British Columbia",Canada,126,8,12,20,305
"Mackey, Reg",D,05/07/1900,"Ottawa, Ontario",Canada,41,0,0,0,16
"Mackie, Howard",D,08/30/1913,"Kitchener, Ontario",Canada,16,1,0,1,4
"MacKinnon, Nathan",F,09/01/1995,"Halifax, Nova Scotia",Canada,638,242,406,648,276
"MacKinnon, Paul",D,11/06/1958,"Brantford, Ontario",Canada,147,5,23,28,91
"MacLean, Brett",F,12/24/1988,"London, Ontario",Canada,18,2,3,5,4
"MacLean, Donald",F,01/14/1977,"Sydney, Nova Scotia",Canada,41,8,5,13,6
"MacLean, John",F,11/20/1964,"Oshawa, Ontario",Canada,1194,413,429,842,1328
"MacLean, Paul",F,03/09/1958,Grostenquin,France,719,324,349,673,968
"MacLeish, Rick",F,01/03/1950,"Lindsay, Ontario",Canada,846,349,410,759,434
"MaClellan, Brian",F,10/27/1958,"Guelph, Ontario",Canada,606,172,241,413,551
"MaCleod, Pat",D,06/15/1969,"Melfort, Saskatchewan",Canada,53,5,13,18,14
"MacMillan, Bill",F,03/07/1943,"Charlottetown, Prince Edward Island",Canada,446,74,77,151,184
"MacMillan, Bob",F,12/03/1952,"Charlottetown, Prince Edward Island",Canada,752,228,349,577,260
"MacMillan, Jeff",D,03/30/1979,"Durham, Ontario",Canada,4,0,0,0,0
"MacMillan, John",F,10/25/1935,"Lethbridge, Alberta",Canada,104,5,10,15,30
"MacNeil, Al",D,09/27/1935,"Sydney, Nova Scotia",Canada,524,17,75,92,615
"MacNeil, Bernie",F,03/07/1950,"Sudbury, Ontario",Canada,4,0,0,0,0
"MacNeil, Ian",F,04/27/1977,"Halifax, Nova Scotia",Canada,2,0,0,0,0
"Macoun, Jamie",D,08/17/1961,"Newmarket, Ontario",Canada,1128,76,282,358,1210
"MacPherson, Bud",D,03/31/1927,"Edmonton, Alberta",Canada,259,5,33,38,233
"MacSweyn, Ralph",D,09/08/1942,"Hawkesbury, Ontario",Canada,47,0,5,5,10
"MacTavish, Craig",F,08/15/1958,"London, Ontario",Canada,1093,213,267,480,891
"MacWilliam, Andrew",D,03/25/1990,"Calgary, Alberta",Canada,12,0,2,2,12
"MacWilliam, Mike",F,02/14/1967,"Burnaby, British Columbia",Canada,6,0,0,0,14
"Madden, John",F,05/04/1973,"Barrie, Ontario",Canada,898,165,183,348,219
"Madeley, Darrin",G,02/25/1968,"Holland Landing, Ontario",Canada,39,0,0,0,0
"Madigan, Connie",D,10/04/1934,"Thunder Bay, Ontario",Canada,20,0,3,3,25
"Madill, Jeff",F,06/21/1965,"Oshawa, Ontario",Canada,14,4,0,4,46
"Mäenalanen, Saku",F,05/29/1994,Kemi,Finland,34,4,4,8,20
"Magee, Dean",F,04/29/1955,"Rocky Mountain House, Alberta",Canada,7,0,0,0,4
"Maggs, Darryl",D,04/06/1949,"Victoria, British Columbia",Canada,135,14,19,33,54
"Magnan, Marc",F,02/17/1962,"Edmonton, Alberta",Canada,4,0,1,1,5
"Magnan, Olivier",D,05/01/1986,"Sherbrooke, Quebec",Canada,18,0,0,0,4
"Magnuson, Keith",D,04/27/1947,"Saskatoon, Saskatchewan",Canada,589,14,125,139,1440
"Maguire, Kevin",F,01/05/1963,"Toronto, Ontario",Canada,260,29,30,59,782
"Mahaffy, John",F,07/18/1919,"Montréal, Quebec",Canada,37,11,25,36,4
"Mahovlich, Frank",F,01/10/1938,"Timmins, Ontario",Canada,1181,533,570,1103,1054
"Mahovlich, Pete",F,10/10/1946,"Timmins, Ontario",Canada,883,288,485,773,916
"Mahura, Joshua",D,05/05/1998,"St. Albert, Alberta",Canada,79,6,14,20,22
"Mailhot, Jacques",F,12/05/1961,"Shawinigan, Quebec",Canada,5,0,0,0,33
"Maillet, Philippe",F,11/07/1992,"Lachenaie, Quebec",Canada,2,0,0,0,0
"Mailley, Frank",D,08/01/1916,"Lachine, Quebec",Canada,1,0,0,0,0
"Mair, Adam",F,02/15/1979,"Hamilton, Ontario",Canada,615,38,76,114,829
"Mair, Jim",D,05/15/1946,"Timmins, Ontario",Canada,76,4,15,19,49
"Majeau, Fern",F,05/03/1916,"Verdun, Quebec",Canada,56,22,24,46,43
"Majeský, Ivan",D,09/02/1976,Banska Bystrica,Slovakia,202,8,23,31,234
"Major, Bruce",F,01/03/1967,"Vernon, British Columbia",Canada,4,0,0,0,0
"Major, Mark",F,03/20/1970,"Toronto, Ontario",Canada,2,0,0,0,5
"Makar, Cale",D,10/30/1998,"Calgary, Alberta",Canada,178,48,132,180,50
"Makarov, Andrei",G,04/20/1993,Kazan,Russia,1,0,0,0,0
"Makarov, Sergei",F,06/19/1958,Chelyabinsk,Russia,424,134,250,384,317
"Mäkelä, Mikko",F,02/28/1965,Tampere,Finland,423,118,147,265,139
"Maki, Ron 'Chico'",F,08/17/1939,"Sault Ste. Marie, Ontario",Canada,841,143,293,436,345
"Mäki, Tomi",F,08/19/1983,Helsinki,Finland,1,0,0,0,0
"Maki, Wayne",F,11/10/1944,"Sault Ste. Marie, Ontario",Canada,246,57,79,136,182
"Makkonen, Kari",F,01/20/1955,Harjavalta,Finland,9,2,2,4,0
"Malakhov, Vladimir",D,08/30/1968,Yekaterinburg,Russia,712,86,260,346,697
"Malarchuk, Clint",G,05/01/1961,"Grande Prairie, Alberta",Canada,337,0,15,15,134
"Malec, Tomas",D,05/13/1982,Skalica,Slovakia,46,0,2,2,47
"Malenstyn, Beck",F,02/04/1998,"White Rock, British Columbia",Canada,15,1,0,1,9
"Maley, David",F,04/24/1963,"Beaver Dam, Wisconsin",United States,466,43,81,124,1043
"Malgin, Denis",F,01/18/1997,Olten,Switzerland,192,28,32,60,42
"Malgunas, Stewart",D,04/21/1970,"Prince George, British Columbia",Canada,129,1,5,6,144
"Malhotra, Manny",F,05/18/1980,"Mississauga, Ontario",Canada,991,116,179,295,451
"Malík, Marek",D,06/24/1975,Ostrava,Czech Republic,691,33,135,168,620
"Malinowski, Merlin",F,09/27/1958,"North Battleford, Saskatchewan",Canada,282,54,111,165,121
"Malkin, Evgeni",F,07/31/1986,Magnitogorsk,Russia,981,444,702,1146,1008
"Malkoc, Dean",D,01/26/1970,"Vancouver, British Columbia",Canada,116,1,3,4,299
"Mallette, Troy",F,02/25/1970,"Sudbury, Ontario",Canada,456,51,68,119,1226
"Malmivaara, Olli",D,03/13/1982,Kajaani,Finland,2,0,0,0,0
"Malone, Brad",F,05/20/1989,"Miramichi, New Brunswick",Canada,207,14,18,32,200
"Malone, Cliff",F,09/04/1925,"Québec City, Quebec",Canada,3,0,0,0,0
"Malone, Greg",F,03/08/1956,"Fredericton, New Brunswick",Canada,704,191,310,501,661
"Malone, Joe",F,02/28/1890,"Québec City, Quebec",Canada,126,143,33,176,57
"Malone, Ryan",F,12/01/1979,"Pittsburgh, Pennsylvania",United States,647,179,191,370,693
"Malone, Sean",F,04/30/1995,"West Seneca, New York",United States,2,0,1,1,2
"Maloney, Dan",F,09/24/1950,"Barrie, Ontario",Canada,737,192,259,451,1489
"Maloney, Dave",D,07/31/1956,"Kitchener, Ontario",Canada,657,71,246,317,1154
"Maloney, Don",F,09/05/1958,"Lindsay, Ontario",Canada,765,214,350,564,815
"Maloney, Phil",F,10/06/1927,"Ottawa, Ontario",Canada,159,28,43,71,12
"Malott, Jeff",F,08/07/1996,"Burlington, Ontario",Canada,1,0,0,0,2
"Maltais, Steve",F,01/25/1969,"Arvida, Quebec",Canada,120,9,18,27,53
"Maltby, Kirk",F,12/22/1972,"Guelph, Ontario",Canada,1072,128,132,260,867
"Maltsev, Mikhail",F,03/12/1998,Saint Petersburg,Russia,51,6,3,9,6
"Maluta, Ray",D,07/24/1954,"Flin Flon, Manitoba",Canada,25,2,3,5,6
"Mamin, Maxim",F,01/13/1995,Moscow,Russia,73,10,8,18,25
"Manastersky, Tom",D,03/07/1929,"Montréal, Quebec",Canada,6,0,0,0,11
"Mancari, Mark",F,07/11/1985,"London, Ontario",Canada,42,3,10,13,22
"Mancuso, Felix 'Gus'",F,04/11/1914,"Niagara Falls, Ontario",Canada,47,7,9,16,23
"Manderville, Kent",F,04/12/1971,"Edmonton, Alberta",Canada,646,37,67,104,348
"Mandich, Dan",D,06/12/1960,"Brantford, Ontario",Canada,111,5,11,16,303
"Maneluk, George",G,07/25/1967,"Winnipeg, Manitoba",Canada,4,0,0,0,2
"Maneluk, Mike",F,10/01/1973,"Winnipeg, Manitoba",Canada,85,11,10,21,57
"Manery, Kris",F,09/24/1954,"Leamington, Ontario",Canada,250,63,64,127,91
"Manery, Randy",D,01/10/1949,"Leamington, Ontario",Canada,582,50,206,256,415
"Mangiapane, Andrew",F,04/04/1996,"Barrie, Ontario",Canada,260,78,54,132,94
"Maniago, Cesare",G,01/13/1939,"Trail, British Columbia",Canada,568,0,4,4,71
"Manlow, Eric",F,04/07/1975,"Belleville, Ontario",Canada,37,2,4,6,8
"Mann, Cameron",F,04/20/1977,"Thompson, Manitoba",Canada,93,14,10,24,40
"Mann, Jack",F,07/27/1919,"Winnipeg, Manitoba",Canada,9,3,4,7,0
"Mann, Jimmy",F,04/17/1959,"Montréal, Quebec",Canada,293,10,20,30,895
"Mann, Ken",F,09/05/1953,"Hamilton, Ontario",Canada,1,0,0,0,0
"Mann, Norm",F,03/03/1914,"Bradford, England",United Kingdom,31,0,3,3,4
"Manners, Ren",F,02/05/1904,"Ottawa, Ontario",Canada,37,3,3,6,14
"Manning, Brandon",D,06/04/1990,"Prince George, British Columbia",Canada,255,14,34,48,254
"Manning, Paul",D,04/15/1979,"Red Deer, Alberta",Canada,8,0,0,0,2
"Mannino, Peter",G,02/17/1984,"Farmington Hills, Michigan",United States,6,0,0,0,0
"Manno, Bob",D,10/31/1956,"Niagara Falls, Ontario",Canada,371,41,132,173,274
"Manson, Dave",D,01/27/1967,"Prince Albert, Saskatchewan",Canada,1103,102,288,390,2792
"Manson, Josh",D,10/07/1991,"Hinsdale, Illinois",United States,475,28,92,120,443
"Manson, Ray",F,12/03/1926,"St. Boniface, Manitoba",Canada,2,0,1,1,0
"Mantha, Anthony",F,09/16/1994,"Longueuil, Quebec",Canada,353,108,117,225,210
"Mantha, Georges",F,11/29/1908,"Lachine, Quebec",Canada,488,90,103,193,146
"Mantha, Moe",D,01/21/1961,"Lakewood, Ohio",United States,656,81,289,370,501
"Mantha, Sylvio",D,04/14/1902,"Montréal, Quebec",Canada,542,63,77,140,675
"Mapletoft, Justin",F,01/11/1981,"Lloydminster, Saskatchewan",Canada,38,3,6,9,8
"Mara, Paul",D,09/07/1979,"Ridgewood, New Jersey",United States,734,64,189,253,776
"Maracle, Henry",F,09/08/1904,"Ayr, Ontario",Canada,11,1,3,4,4
"Maracle, Norm",G,10/02/1974,"Belleville, Ontario",Canada,66,0,0,0,0
"Marcetta, Milan",F,09/19/1936,"Cadomin, Alberta",Canada,54,7,15,22,12
"March, Harold 'Mush'",F,10/18/1908,"Silton, Saskatchewan",Canada,761,153,231,384,546
"Marchand, Brad",F,05/11/1988,"Halifax, Nova Scotia",Canada,874,351,444,795,899
"Marchant, Todd",F,08/12/1973,"Buffalo, New York",United States,1195,186,312,498,774
"Marchenko, Alexei",D,01/02/1992,Moscow,Russia,121,4,17,21,26
"Marchessault, Jonathan",F,12/27/1990,"Cap-Rouge, Quebec",Canada,480,160,201,361,250
"Marchinko, Brian",F,08/02/1948,"Weyburn, Saskatchewan",Canada,47,2,6,8,0
"Marchment, Bryan",D,05/01/1969,"Scarborough, Ontario",Canada,926,40,142,182,2307
"Marchment, Mason",F,06/18/1995,"Uxbridge, Ontario",Canada,91,20,38,58,71
"Marcinyshyn, Dave",D,02/04/1967,"Edmonton, Alberta",Canada,16,0,1,1,49
"Marcon, Lou",D,05/28/1935,"Thunder Bay, Ontario",Canada,60,0,4,4,42
"Marcotte, Don",F,04/15/1947,"Asbestos, Quebec",Canada,868,230,254,484,317
"Marha, Josef",F,06/02/1976,Havlickuv Brod,Czech Republic,159,21,32,53,32
"Marincin, Martin",D,02/18/1992,Kosice,Slovakia,227,5,29,34,110
"Marini, Hector",F,01/27/1957,"Timmins, Ontario",Canada,154,27,46,73,248
"Marino, John",D,05/21/1997,"Brockton, Massachusetts",United States,189,10,54,64,51
"Marinucci, Chris",F,12/29/1971,"Grand Rapids, Minnesota",United States,13,1,4,5,2
"Mario, Frank",F,02/25/1921,"Esterhazy, Saskatchewan",Canada,53,9,19,28,24
"Mariucci, John",D,05/08/1916,"Eveleth, Minnesota",United States,224,11,34,45,328
"Marjamäki, Masi",F,01/16/1985,Pori,Finland,1,0,0,0,0
"Mark, Gord",D,09/10/1964,"Edmonton, Alberta",Canada,85,3,10,13,187
"Markell, John",F,03/10/1956,"Cornwall, Ontario",Canada,55,11,10,21,36
"Marker, Gus",F,08/01/1907,"Wetaskiwin, Alberta",Canada,323,64,70,134,133
"Markham, Ray",F,01/23/1958,"Windsor, Ontario",Canada,14,1,1,2,21
"Markkanen, Jussi",G,05/08/1975,Imatra,Finland,128,0,2,2,4
"Markle, Jack",F,05/15/1907,"Thessalon, Ontario",Canada,8,0,1,1,0
"Markov, Andrei",D,12/20/1978,Voskresensk,Russia,990,119,453,572,505
"Markov, Danil",D,07/30/1976,Moscow,Russia,538,29,118,147,456
"Marks, Jack",F,06/11/1885,"Brantford, Ontario",Canada,7,0,0,0,4
"Marks, John",F,03/22/1948,"Hamiota, Manitoba",Canada,657,112,163,275,330
"Markström, Jacob",G,01/31/1990,Gävle,Sweden,378,0,12,12,28
"Markwart, Nevin",F,12/09/1964,"Toronto, Ontario",Canada,309,41,68,109,794
"Marleau, Patrick",F,09/15/1979,"Swift Current, Saskatchewan",Canada,1779,566,631,1197,527
"Marner, Mitchell",F,05/05/1997,"Markham, Ontario",Canada,427,138,317,455,138
"Marody, Cooper",F,12/20/1996,"Brighton, Michigan",United States,7,0,1,1,0
"Marois, Daniel",F,10/03/1968,"Montréal, Quebec",Canada,350,117,93,210,419
"Marois, Jean",G,05/11/1924,"Québec City, Quebec",Canada,3,0,0,0,0
"Marois, Mario",D,12/15/1957,"L'Ancienne-Lorette, Quebec",Canada,956,76,357,433,1746
"Maroon, Patrick",F,04/23/1988,"St. Louis, Missouri",United States,649,112,162,274,780
"Marotte, Gilles",D,06/07/1945,"Montréal, Quebec",Canada,808,56,265,321,921
"Marquess, Mark",F,03/26/1925,"Bassano, Alberta",Canada,27,5,4,9,6
"Marsh, Brad",D,03/31/1958,"London, Ontario",Canada,1086,23,175,198,1241
"Marsh, Gary",F,03/09/1946,"Toronto, Ontario",Canada,7,1,3,4,4
"Marsh, Peter",F,12/21/1956,"Halifax, Nova Scotia",Canada,278,48,71,119,224
"Marshall, Bert",D,11/22/1943,"Kamloops, British Columbia",Canada,868,17,181,198,926
"Marshall, Don",F,03/23/1932,"Montréal, Quebec",Canada,1176,265,324,589,125
"Marshall, Grant",F,06/09/1973,"Mississauga, Ontario",Canada,700,92,147,239,793
"Marshall, Jason",D,02/22/1971,"Cranbrook, British Columbia",Canada,526,16,51,67,1004
"Marshall, Kevin",D,03/10/1989,"Boucherville, Quebec",Canada,10,0,0,0,8
"Marshall, Paul",F,09/07/1960,"Toronto, Ontario",Canada,95,15,18,33,17
"Marshall, Willie",F,12/01/1931,"Kirkland Lake, Ontario",Canada,33,1,5,6,2
"Marson, Mike",F,07/24/1955,"Scarborough, Ontario",Canada,196,24,24,48,233
"Martel, Danick",F,12/12/1994,"Drummondville, Quebec",Canada,13,0,2,2,8
"Mårtensson, Tony",F,06/23/1980,Upplands Väsby,Sweden,6,1,1,2,0
"Martin, Clare",D,02/25/1922,"Waterloo, Ontario",Canada,237,12,28,40,78
"Martin, Craig",F,01/21/1971,"Amherst, Nova Scotia",Canada,21,0,1,1,24
"Martin, Frank",D,05/01/1933,"Cayuga, Ontario",Canada,282,11,46,57,122
"Martin, Grant",F,03/13/1962,"Smooth Rock Falls, Ontario",Canada,44,0,4,4,55
"Martin, Hubert 'Pit'",F,12/09/1943,"Rouyn-Noranda, Quebec",Canada,1101,324,485,809,609
"Martin, Jack",F,11/29/1940,"St. Catharines, Ontario",Canada,1,0,0,0,0
"Martin, Matt",D,04/30/1971,"Hamden, Connecticut",United States,76,0,5,5,71
"Martin, Matthew",F,05/08/1989,"Windsor, Ontario",Canada,817,70,79,149,1052
"Martin, Paul",D,03/05/1981,"Minneapolis, Minnesota",United States,870,50,270,320,238
"Martin, Rick",F,07/26/1951,"Verdun, Quebec",Canada,685,384,317,701,477
"Martin, Ronnie",F,08/22/1909,"Calgary, Alberta",Canada,94,13,16,29,36
"Martin, Seth",G,05/04/1933,"Rossland, British Columbia",Canada,30,0,1,1,0
"Martin, Spencer",G,06/08/1995,"Oakville, Ontario",Canada,9,0,0,0,0
"Martin, Terry",F,10/25/1955,"Barrie, Ontario",Canada,479,104,101,205,202
"Martin, Tom",F,10/16/1947,"Toronto, Ontario",Canada,3,1,0,1,0
"Martin, Tom",F,05/11/1964,"Kelowna, British Columbia",Canada,92,12,11,23,259
"Martineau, Don",F,04/25/1952,"Kimberley, British Columbia",Canada,90,6,10,16,63
"Martínek, Radek",D,08/31/1976,Havlickuv Brod,Czech Republic,486,25,85,110,280
"Martinez, Alec",D,07/26/1987,"Rochester Hills, Michigan",United States,686,76,170,246,207
"Martini, Darcy",D,01/30/1969,"Castlegar, British Columbia",Canada,2,0,0,0,0
"Martinook, Jordan",F,07/25/1992,"Brandon, Manitoba",Canada,477,53,78,131,210
"Martins, Steve",F,04/13/1972,"Gatineau, Quebec",Canada,267,21,25,46,142
"Martinsen, Andreas",F,06/13/1990,Baerum,Norway,152,9,14,23,110
"Martinson, Steve",F,06/21/1957,"Minnetonka, Minnesota",United States,49,2,1,3,244
"Maruk, Dennis",F,11/17/1955,"Toronto, Ontario",Canada,888,356,522,878,761
"Mashinter, Brandon",F,09/20/1988,"Bradford, Ontario",Canada,64,4,1,5,50
"Masnick, Paul",F,04/14/1931,"Regina, Saskatchewan",Canada,232,18,41,59,139
"Mason, Bob",G,04/22/1961,"International Falls, Minnesota",United States,145,0,4,4,6
"Mason, Charley",F,02/01/1912,"Seaforth, Ontario",Canada,91,7,18,25,22
"Mason, Chris",G,04/20/1976,"Red Deer, Alberta",Canada,317,1,3,4,12
"Mason, Steve",G,05/29/1988,"Oakville, Ontario",Canada,476,0,12,12,22
"Massecar, George",F,07/10/1904,"Waterford, Ontario",Canada,100,12,11,23,46
"Masters, Jamie",D,04/14/1955,"Toronto, Ontario",Canada,33,1,13,14,2
"Masterton, Bill",F,08/13/1938,"Winnipeg, Manitoba",Canada,38,4,8,12,4
"Mathers, Frank",D,03/29/1924,"Winnipeg, Manitoba",Canada,23,1,3,4,4
"Matheson, Michael",D,02/27/1994,"Montréal, Quebec",Canada,417,49,89,138,218
"Mathiasen, Dwight",F,12/05/1963,"Brandon, Manitoba",Canada,33,1,7,8,18
"Mathieson, Jim",D,01/24/1970,"Kindersley, Saskatchewan",Canada,2,0,0,0,4
"Mathieu, Marquis",F,05/31/1973,"Hartford, Connecticut",United States,16,0,2,2,14
"Matsumoto, Jon",F,10/13/1986,"Ottawa, Ontario",Canada,14,2,0,2,4
"Matte, Christian",F,01/20/1975,"Hull, Quebec",Canada,25,2,3,5,12
"Matte, Joe",D,03/06/1893,"Bourget, Ontario",Canada,68,17,15,32,52
"Matte, Joe",D,03/15/1909,"Bourget, Ontario",Canada,24,0,3,3,8
"Matteau, Stefan",F,02/23/1994,"Chicago, Illinois",United States,92,6,5,11,41
"Matteau, Stephane",F,09/02/1969,"Rouyn-Noranda, Quebec",Canada,848,144,172,316,742
"Matteucci, Mike",D,12/27/1971,"Trail, British Columbia",Canada,6,0,0,0,4
"Matthews, Auston",F,09/17/1997,"San Ramon, California",United States,407,259,198,457,74
"Matthias, Shawn",F,02/19/1988,"Mississauga, Ontario",Canada,551,90,84,174,180
"Mattiussi, Dick",D,05/01/1938,"Smooth Rock Falls, Ontario",Canada,200,8,31,39,124
"Mattsson, Markus",G,07/30/1957,Suoniemi,Finland,92,0,3,3,6
"Matvichuk, Richard",D,02/05/1973,"Edmonton, Alberta",Canada,796,39,139,178,624
"Matz, Johnny",F,06/01/1891,"Omaha, Nebraska",United States,30,2,4,6,0
"Mauldin, Greg",F,06/10/1982,"Boston, Massachusetts",United States,36,5,5,10,12
"Maxner, Wayne",F,09/27/1942,"Halifax, Nova Scotia",Canada,61,8,9,17,48
"Maxwell, Ben",F,03/30/1988,"North Vancouver, British Columbia",Canada,47,2,6,8,19
"Maxwell, Brad",D,07/08/1957,"Brandon, Manitoba",Canada,613,98,270,368,1292
"Maxwell, Bryan",D,09/07/1955,"North Bay, Ontario",Canada,330,18,77,95,745
"Maxwell, Kevin",F,03/30/1960,"Edmonton, Alberta",Canada,66,6,15,21,61
"Maxwell, Wally",F,08/24/1933,"Ottawa, Ontario",Canada,2,0,0,0,0
"May, Alan",F,01/14/1965,"Swan Hills, Alberta",Canada,393,31,45,76,1348
"May, Brad",F,11/29/1971,"Toronto, Ontario",Canada,1041,127,161,288,2248
"May, Darrell",G,03/06/1962,"Montréal, Quebec",Canada,6,0,1,1,2
"Mayer, Derek",D,05/21/1967,"Rossland, British Columbia",Canada,17,2,2,4,8
"Mayer, Gilles",G,08/24/1930,"Ottawa, Ontario",Canada,9,0,0,0,0
"Mayer, Jim",F,10/30/1954,"Capreol, Ontario",Canada,4,0,0,0,0
"Mayer, Pat",D,07/24/1961,"Royal Oak, Michigan",United States,1,0,0,0,4
"Mayer, Shep",F,09/11/1923,"Sturgeon Falls, Ontario",Canada,2,1,2,3,4
"Mayers, Jamal",F,10/24/1974,"Toronto, Ontario",Canada,915,90,129,219,1200
"Mayfield, Scott",D,10/14/1992,"St. Louis, Missouri",United States,346,19,68,87,312
"Mayhew, Gerald",F,12/31/1992,"Wyandotte, Michigan",United States,57,13,2,15,20
"Mayo, Dysin",D,08/17/1996,"Victoria, British Columbia",Canada,67,4,8,12,27
"Mayorov, Maxim",F,03/26/1989,Andijan,Uzbekistan,22,2,1,3,2
"Mazanec, Marek",G,07/18/1991,Pisek,Czech Republic,31,0,1,1,0
"Mazur, Eddie",F,07/25/1929,"Winnipeg, Manitoba",Canada,107,8,20,28,118
"Mazur, Jay",F,01/22/1965,"Hamilton, Ontario",Canada,47,11,7,18,20
"McAdam, Gary",F,12/31/1955,"Smiths Falls, Ontario",Canada,534,96,132,228,243
"McAdam, Sammy",F,05/31/1908,"Stirling, Scotland",United Kingdom,5,0,0,0,0
"McAllister, Chris",D,06/16/1975,"Saskatoon, Saskatchewan",Canada,301,4,17,21,634
"McAlpine, Chris",D,12/01/1971,"Roseville, Minnesota",United States,289,6,24,30,245
"McAmmond, Dean",F,06/15/1973,"Grande Cache, Alberta",Canada,996,186,262,448,490
"McAndrew, Hazen",D,08/07/1917,"Mayo, Quebec",Canada,7,0,1,1,6
"McAneeley, Ted",D,11/07/1950,"Cranbrook, British Columbia",Canada,158,8,35,43,141
"McArdle, Kenndal",F,01/04/1987,"Toronto, Ontario",Canada,42,1,2,3,51
"McAtee, Jerome 'Jud'",F,02/05/1920,"Stratford, Ontario",Canada,46,15,13,28,6
"McAtee, Norm",F,06/28/1921,"Stratford, Ontario",Canada,13,0,1,1,0
"McAuley, Ken",G,01/09/1921,"Edmonton, Alberta",Canada,96,0,0,0,0
"McAvoy, Charlie",D,12/21/1997,"Long Beach, New York",United States,313,34,144,178,243
"McBain, Andrew",F,01/18/1965,"Toronto, Ontario",Canada,608,129,172,301,631
"McBain, Jack",F,01/06/2000,"Toronto, Ontario",Canada,10,2,1,3,6
"McBain, Jamie",D,02/25/1988,"Edina, Minnesota",United States,348,30,80,110,72
"McBain, Jason",D,04/12/1974,"Ilion, New York",United States,9,0,0,0,0
"McBain, Mike",D,01/12/1977,"Kimberley, British Columbia",Canada,64,0,7,7,22
"McBean, Wayne",D,02/21/1969,"Calgary, Alberta",Canada,211,10,39,49,168
"Mcbride, Cliff",D,01/10/1909,"Toronto, Ontario",Canada,1,0,0,0,0
"McBurney, Jim",F,06/03/1933,"Sault Ste. Marie, Ontario",Canada,1,0,1,1,0
"McCabe, Bryan",D,06/08/1975,"St. Catharines, Ontario",Canada,1135,145,383,528,1732
"McCabe, Jake",D,10/12/1993,"Eau Claire, Wisconsin",United States,428,22,77,99,236
"McCabe, Stan",D,06/16/1908,"Ottawa, Ontario",Canada,74,9,5,14,49
"McCaffrey, Bert",D,04/12/1893,"Chesley, Ontario",Canada,261,43,35,78,204
"McCahill, John",D,12/02/1955,"Sarnia, Ontario",Canada,1,0,0,0,0
"McCaig, Doug",D,02/24/1919,"Guelph, Ontario",Canada,263,8,21,29,255
"McCallum, Dunc",D,03/29/1940,"Flin Flon, Manitoba",Canada,187,14,35,49,230
"McCalmon, Eddie",F,05/30/1902,"Varney, Ontario",Canada,39,5,0,5,12
"McCann, Jared",F,05/31/1996,"Stratford, Ontario",Canada,427,93,112,205,155
"McCann, Rick",F,05/27/1944,"Hamilton, Ontario",Canada,42,1,4,5,6
"McCarron, Michael",F,03/07/1995,"Macomb Township, Michigan",United States,126,9,13,22,196
"McCartan, Jack",G,08/05/1935,"St. Paul, Minnesota",United States,12,0,0,0,0
"McCarthy, Dan",F,04/07/1958,"St. Marys, Ontario",Canada,5,4,0,4,4
"McCarthy, John",F,08/09/1986,"Boston, Massachusetts",United States,88,3,3,6,22
"McCarthy, Kevin",D,07/14/1957,"Winnipeg, Manitoba",Canada,537,67,191,258,527
"McCarthy, Sandy",F,06/15/1972,"Toronto, Ontario",Canada,736,72,76,148,1534
"McCarthy, Steve",D,02/03/1981,"Trail, British Columbia",Canada,302,17,38,55,168
"McCarthy, Tom",F,04/12/1893,"St. Peter's, Nova Scotia",Canada,35,22,7,29,10
"McCarthy, Tom",F,07/31/1960,"Toronto, Ontario",Canada,460,178,221,399,330
"McCarthy, Tom",F,09/15/1934,"Toronto, Ontario",Canada,60,8,9,17,8
"McCartney, Ben",F,07/13/2001,"Portage la Prairie, Manitoba",Canada,2,0,0,0,4
"McCartney, Walt",D,04/26/1911,"Regina, Saskatchewan",Canada,2,0,0,0,0
"McCarty, Darren",F,04/01/1972,"Burnaby, British Columbia",Canada,758,127,161,288,1477
"McCaskill, Ted",F,10/29/1936,"Kapuskasing, Ontario",Canada,4,0,2,2,0
"McCauley, Alyn",F,05/29/1977,"Brockville, Ontario",Canada,488,69,97,166,116
"McClanahan, Rob",F,01/09/1958,"St. Paul, Minnesota",United States,224,38,63,101,126
"McCleary, Trent",F,09/08/1972,"Swift Current, Saskatchewan",Canada,192,8,15,23,134
"McClelland, Kevin",F,07/04/1962,"Oshawa, Ontario",Canada,588,68,112,180,1670
"McClement, Jay",F,03/02/1983,"Kingston, Ontario",Canada,906,90,154,244,325
"McCollum, Thomas",G,12/07/1989,"Amherst, New York",United States,3,0,0,0,0
"McCool, Frank",G,10/27/1918,"Calgary, Alberta",Canada,72,0,0,0,5
"McCord, Bob",D,03/30/1934,"Matheson, Ontario",Canada,316,10,58,68,257
"McCord, Dennis",D,07/28/1952,"Chatham, Ontario",Canada,3,0,0,0,6
"McCormack, John",F,08/02/1925,"Edmonton, Alberta",Canada,311,25,49,74,35
"McCormick, Cody",F,04/18/1983,"London, Ontario",Canada,405,21,44,65,550
"McCormick, Max",F,05/01/1992,"De Pere, Wisconsin",United States,93,8,5,13,97
"McCosh, Shawn",F,06/05/1969,"Oshawa, Ontario",Canada,9,1,0,1,6
"McCoshen, Ian",D,08/05/1995,"Anaheim, California",United States,60,4,3,7,33
"McCourt, Dale",F,01/26/1957,"Falconbridge, Ontario",Canada,532,194,284,478,124
"McCreary, Bill",F,04/15/1960,"Springfield, Massachusetts",United States,12,1,0,1,4
"McCreary, Bill",F,12/02/1934,"Sundridge, Ontario",Canada,309,53,62,115,106
"McCreary, Keith",F,06/19/1940,"Sundridge, Ontario",Canada,532,131,112,243,294
"McCreedy, Johnny",F,03/23/1911,"Winnipeg, Manitoba",Canada,64,17,12,29,25
"McCrimmon, Brad",D,03/29/1959,"Dodsland, Saskatchewan",Canada,1222,81,322,403,1416
"McCrimmon, Jim",D,05/29/1953,"Ponoka, Alberta",Canada,2,0,0,0,0
"McCulley, Bob",F,02/08/1914,"Stratford, Ontario",Canada,1,0,0,0,0
"McCurry, Duke",F,06/13/1900,"Toronto, Ontario",Canada,148,21,12,33,121
"McCutcheon, Brian",F,08/03/1949,"Toronto, Ontario",Canada,37,3,1,4,7
"McCutcheon, Darwin",D,04/19/1962,"Listowel, Ontario",Canada,1,0,0,0,2
"McDavid, Connor",F,01/13/1997,"Richmond Hill, Ontario",Canada,487,239,458,697,183
"McDill, Jeff",F,03/16/1956,"Thunder Bay, Ontario",Canada,1,0,0,0,0
"McDonagh, Bill",F,04/30/1928,"Rouyn-Noranda, Quebec",Canada,4,0,0,0,2
"McDonagh, Ryan",D,06/13/1989,"St. Paul, Minnesota",United States,783,71,266,337,304
"McDonald, Ab",F,02/18/1936,"Winnipeg, Manitoba",Canada,762,182,248,430,198
"McDonald, Andy",F,08/25/1977,"Strathroy, Ontario",Canada,685,182,307,489,280
"McDonald, Bob",F,01/04/1923,"Toronto, Ontario",Canada,1,0,0,0,0
"McDonald, Brian",F,03/23/1945,"Toronto, Ontario",Canada,12,0,0,0,29
"McDonald, Butch",F,11/21/1916,"Moose Jaw, Saskatchewan",Canada,66,8,20,28,2
"McDonald, Colin",F,09/30/1984,"New Haven, Connecticut",United States,148,20,26,46,73
"McDonald, Gerry",D,03/18/1958,"Weymouth, Massachusetts",United States,8,0,0,0,4
"McDonald, Jack",F,02/28/1887,"Québec City, Quebec",Canada,70,26,14,40,27
"McDonald, John",F,11/24/1921,"Swan River, Manitoba",Canada,43,10,9,19,6
"McDonald, Lanny",F,02/16/1953,"Hanna, Alberta",Canada,1111,500,506,1006,899
"McDonald, Terry",D,06/17/1955,"Coquitlam, British Columbia",Canada,8,0,1,1,6
"McDonald, Wilfred",D,10/31/1914,"Fergus, Ontario",Canada,446,35,88,123,206
"McDonell, Kent",F,03/01/1979,"Williamstown, Ontario",Canada,32,1,2,3,36
"McDonnell, Joe",D,05/11/1961,"Kitchener, Ontario",Canada,50,2,10,12,34
"McDonnell, Moylan",D,08/27/1889,"Stony Mountain, Manitoba",Canada,22,1,2,3,2
"McDonough, Al",F,06/06/1950,"Hamilton, Ontario",Canada,237,73,88,161,73
"McDonough, Hubie",F,08/07/1963,"Manchester, New Hampshire",United States,195,40,26,66,67
"McDougal, Mike",F,04/30/1958,"Port Huron, Michigan",United States,61,8,10,18,43
"McDougall, Bill",F,08/10/1966,"Mississauga, Ontario",Canada,28,5,5,10,12
"McDuffe, Peter",G,02/16/1948,"Milton, Ontario",Canada,57,0,1,1,2
"McEachern, Shawn",F,02/28/1969,"Waltham, Massachusetts",United States,911,256,323,579,506
"McElhinney, Curtis",G,05/23/1983,"London, Ontario",Canada,249,0,4,4,4
"McElmury, Jim",D,10/03/1949,"St. Paul, Minnesota",United States,180,14,47,61,49
"McEneny, Evan",D,05/22/1994,"Hamilton, Ontario",Canada,1,0,0,0,0
"McEwen, Mike",D,08/10/1956,"Hornepayne, Ontario",Canada,716,108,296,404,460
"McFadden, Jim",F,04/15/1920,"Belfast, Northern Ireland",United Kingdom,412,100,126,226,89
"McFadyen, Don",F,03/24/1907,"Crossfield, Alberta",Canada,176,12,34,46,77
"McFall, Dan",D,04/08/1963,"Kenmore, New York",United States,9,0,1,1,0
"McFarland, John",F,04/02/1992,"Richmond Hill, Ontario",Canada,3,0,0,0,0
"McFarlane, Gord",D,07/18/1901,"Snow Lake, Manitoba",Canada,2,0,0,0,0
"McGeough, Jim",F,04/13/1963,"Regina, Saskatchewan",Canada,57,7,10,17,32
"McGibbon, Irv",F,10/11/1914,"Antigonish, Nova Scotia",Canada,1,0,0,0,2
"McGill, Bob",D,04/27/1962,"Edmonton, Alberta",Canada,706,17,55,72,1766
"McGill, Jack",F,11/03/1910,"Ottawa, Ontario",Canada,134,27,10,37,71
"McGill, Jack",F,09/19/1921,"Edmonton, Alberta",Canada,98,23,36,59,42
"McGill, Ryan",D,02/28/1969,"Sherwood Park, Alberta",Canada,151,4,15,19,391
"McGillis, Dan",D,07/01/1972,"Hawkesbury, Ontario",Canada,634,56,182,238,570
"McGinn, Brock",F,02/02/1994,"Fergus, Ontario",Canada,409,63,65,128,95
"McGinn, Jamie",F,08/05/1988,"Fergus, Ontario",Canada,617,117,103,220,267
"McGinn, Tye",F,07/29/1990,"Fergus, Ontario",Canada,89,9,8,17,44
"McGrattan, Brian",F,09/02/1981,"Hamilton, Ontario",Canada,317,10,17,27,609
"McGrattan, Tom",G,10/19/1927,"Brantford, Ontario",Canada,1,0,0,0,0
"McGregor, Sandy",F,03/30/1939,"Toronto, Ontario",Canada,2,0,0,0,0
"McGuire, Frank",F,07/07/1898,"Gravenhurst, Ontario",Canada,36,3,0,3,6
"McHugh, Mike",F,08/16/1965,"Bowdoin, Maine",United States,20,1,0,1,16
"McilHargey, Jack",D,03/07/1952,"Edmonton, Alberta",Canada,393,11,36,47,1102
"McIlrath, Dylan",D,04/20/1992,"Winnipeg, Manitoba",Canada,66,3,2,5,121
"McInenly, Bert",D,05/06/1906,"Québec City, Quebec",Canada,166,19,15,34,144
"McInnis, Marty",F,06/02/1970,"Weymouth, Massachusetts",United States,796,170,250,420,330
"McIntosh, Bruce",D,03/17/1949,"Edina, Minnesota",United States,2,0,0,0,0
"McIntosh, Paul",D,03/13/1954,"Listowel, Ontario",Canada,48,0,2,2,66
"McIntyre, David",F,02/04/1987,"Oakville, Ontario",Canada,7,1,1,2,2
"McIntyre, Jack",F,09/08/1930,"Brussels, Ontario",Canada,499,109,102,211,171
"McIntyre, John",F,04/29/1969,"Ravenswood, Ontario",Canada,351,24,54,78,516
"McIntyre, Larry",D,07/13/1949,"Moose Jaw, Saskatchewan",Canada,41,0,3,3,26
"McIntyre, Zane",G,08/20/1992,"Thief River Falls, Minnesota",United States,8,0,0,0,0
"McIver, Nathan",D,01/06/1985,"Summerside, Prince Edward Island",Canada,36,0,1,1,95
"McKay, Randy",F,01/25/1967,"Montréal, Quebec",Canada,932,162,201,363,1731
"McKay, Ray",D,08/22/1946,"Edmonton, Alberta",Canada,140,2,16,18,102
"McKay, Ross",G,03/03/1964,"Edmonton, Alberta",Canada,1,0,0,0,0
"McKay, Scott",F,01/26/1972,"Burlington, Ontario",Canada,1,0,0,0,0
"McKechnie, Walt",F,06/19/1947,"London, Ontario",Canada,955,214,392,606,469
"McKee, Jay",D,09/08/1977,"Kingston, Ontario",Canada,802,21,104,125,622
"McKee, Mike",D,06/18/1969,"Toronto, Ontario",Canada,48,3,12,15,41
"McKegg, Greg",F,06/17/1992,"St. Thomas, Ontario",Canada,233,21,18,39,65
"McKegney, Ian",D,05/07/1947,"Sarnia, Ontario",Canada,3,0,0,0,2
"McKegney, Tony",F,02/15/1958,"Montréal, Quebec",Canada,912,320,319,639,517
"McKendry, Alex",F,11/21/1956,"Midland, Ontario",Canada,46,3,6,9,21
"McKenna, Mike",G,04/11/1983,"St. Louis, Missouri",United States,35,0,1,1,0
"McKenna, Sean",F,03/07/1962,"Asbestos, Quebec",Canada,414,82,80,162,183
"McKenna, Steve",D,08/21/1973,"Toronto, Ontario",Canada,373,18,14,32,824
"McKenney, Don",F,04/30/1934,"Smiths Falls, Ontario",Canada,798,237,345,582,205
"McKenny, Jim",D,12/01/1946,"Ottawa, Ontario",Canada,604,82,247,329,294
"McKenzie, Bill",G,03/12/1949,"St. Thomas, Ontario",Canada,91,0,1,1,12
"McKenzie, Brian",F,03/16/1951,"St. Catharines, Ontario",Canada,6,1,1,2,4
"McKenzie, Curtis",F,02/21/1991,"Burnaby, British Columbia",Canada,99,10,13,23,131
"McKenzie, Jim",F,11/03/1969,"Gull Lake, Saskatchewan",Canada,880,48,52,100,1739
"McKenzie, John",F,12/12/1937,"High River, Alberta",Canada,692,206,268,474,923
"McKeown, Roland",D,01/20/1996,"Listowel, Ontario",Canada,10,0,3,3,19
"McKichan, Steve",G,05/29/1967,"Strathroy, Ontario",Canada,1,0,0,0,0
"McKim, Andrew",F,07/06/1970,"Saint John, New Brunswick",Canada,38,1,4,5,6
"McKinnon, Alex",D,04/17/1895,"Sault Ste. Marie, Ontario",Canada,195,19,12,31,237
"McKinnon, John",D,07/15/1902,"Guysborough, Nova Scotia",Canada,208,28,9,37,195
"McLachlan, Murray",G,10/20/1948,"London, Ontario",Canada,2,0,0,0,0
"McLaren, Frazer",F,10/29/1987,"Winnipeg, Manitoba",Canada,102,4,7,11,264
"McLaren, Kyle",D,06/18/1977,"Humboldt, Saskatchewan",Canada,719,46,161,207,671
"McLaren, Steve",F,02/03/1975,"Owen Sound, Ontario",Canada,6,0,0,0,25
"McLaughlin, Marc",F,07/26/1999,"North Billerica, Massachusetts",United States,11,3,0,3,8
"McLean, Brett",F,08/14/1978,"Comox, British Columbia",Canada,385,56,106,162,204
"McLean, Don",D,01/19/1954,"Niagara Falls, Ontario",Canada,9,0,0,0,6
"McLean, Fred",D,03/16/1893,"Lakeville Corner, New Brunswick",Canada,8,0,0,0,2
"McLean, Jack",F,01/31/1923,"Winnipeg, Manitoba",Canada,67,14,24,38,86
"McLean, Jeff",F,10/06/1969,"Port Moody, British Columbia",Canada,6,1,0,1,0
"McLean, Kirk",G,06/26/1966,"Willowdale, Ontario",Canada,612,0,23,23,58
"McLean, Kurtis",F,11/02/1980,"Kirkland Lake, Ontario",Canada,4,1,0,1,0
"McLellan, John",F,08/06/1928,"Timmins, Ontario",Canada,2,0,0,0,0
"McLellan, Scott",F,02/10/1963,"Toronto, Ontario",Canada,2,0,0,0,0
"McLellan, Todd",F,10/03/1967,"Melville, Saskatchewan",Canada,5,1,1,2,0
"McLelland, Dave",G,11/20/1952,"Penticton, British Columbia",Canada,2,0,0,0,0
"McLenahan, Rollie",D,10/26/1921,"Fredericton, New Brunswick",Canada,8,2,1,3,10
"McLennan, Jamie",G,06/30/1971,"Edmonton, Alberta",Canada,254,0,3,3,54
"McLeod, Al",D,06/17/1949,"Medicine Hat, Alberta",Canada,26,2,2,4,24
"McLeod, Cody",F,06/26/1984,"Binscarth, Manitoba",Canada,776,72,55,127,1630
"McLeod, Don",G,08/24/1946,"Trail, British Columbia",Canada,18,0,0,0,0
"McLeod, Jack",F,04/30/1930,"Regina, Saskatchewan",Canada,106,14,23,37,10
"McLeod, Jimmy",G,04/07/1937,"Thunder Bay, Ontario",Canada,16,0,1,1,0
"Mcleod, Michael",F,02/03/1998,"Mississauga, Ontario",Canada,162,15,25,40,111
"McLeod, Ryan",F,09/21/1999,"Mississauga, Ontario",Canada,81,9,13,22,12
"McLlwain, Dave",F,01/09/1967,"Seaforth, Ontario",Canada,501,100,107,207,292
"McMahon, Mike",D,08/30/1941,"Québec City, Quebec",Canada,224,15,68,83,169
"McMahon, Mike",D,02/01/1915,"Brockville, Ontario",Canada,58,7,18,25,90
"McManama, Bob",F,10/07/1951,"Belmont, Massachusetts",United States,99,11,25,36,28
"McManus, Sammy",F,10/22/1911,"Belfast, Northern Ireland",United Kingdom,26,0,1,1,8
"McMichael, Connor",F,01/15/2001,"Ajax, Ontario",Canada,69,9,9,18,12
"McMillan, Brandon",F,03/22/1990,"Richmond, British Columbia",Canada,171,14,22,36,60
"McMillan, Carson",F,09/10/1988,"Brandon, Manitoba",Canada,16,2,3,5,11
"McMorrow, Sean",F,01/19/1982,"Vancouver, British Columbia",Canada,1,0,0,0,0
"McMurchy, Tom",F,12/02/1963,"New Westminster, British Columbia",Canada,55,8,4,12,65
"McNab, Max",F,06/21/1924,"Watson, Saskatchewan",Canada,128,16,19,35,24
"McNab, Peter",F,05/08/1952,"Vancouver, British Columbia",Canada,955,363,450,813,179
"McNabb, Brayden",D,01/21/1991,"Saskatoon, Saskatchewan",Canada,576,23,93,116,421
"McNamara, Gerry",G,09/22/1934,"Sturgeon Falls, Ontario",Canada,7,0,0,0,2
"McNamara, Howard",D,08/03/1893,"Randolph, Ontario",Canada,10,1,0,1,4
"McNaughton, George",F,04/04/1897,"Gaspé, Quebec",Canada,1,0,0,0,0
"McNeil, Gerry",G,04/17/1926,"Québec City, Quebec",Canada,276,0,0,0,2
"McNeill, Billy",F,01/26/1936,"Edmonton, Alberta",Canada,257,21,46,67,130
"McNeill, Grant",D,06/08/1983,"Vermilion, Alberta",Canada,3,0,0,0,5
"McNeill, Mark",F,02/22/1993,"Edmonton, Alberta",Canada,2,0,0,0,0
"McNeill, Mike",F,07/22/1966,"Winona, Minnesota",United States,63,5,11,16,18
"McNeill, Stu",F,09/25/1938,"Thunder Bay, Ontario",Canada,11,1,1,2,2
"McNiven, Michael",G,07/09/1997,"Georgetown, Ontario",Canada,1,0,0,0,0
"McPhee, George",F,07/02/1958,"Guelph, Ontario",Canada,115,24,25,49,257
"McPhee, Mike",F,07/14/1960,"Sydney, Nova Scotia",Canada,744,200,199,399,661
"McQuaid, Adam",D,10/12/1986,"Charlottetown, Prince Edward Island",Canada,512,16,57,73,694
"McRae, Basil",F,01/05/1961,"Beaverton, Ontario",Canada,576,53,83,136,2457
"McRae, Chris",F,08/26/1965,"Beaverton, Ontario",Canada,21,1,0,1,122
"McRae, Gord",G,04/12/1948,"Sherbrooke, Quebec",Canada,71,0,0,0,6
"McRae, Ken",F,04/23/1968,"Winchester, Ontario",Canada,137,14,21,35,364
"McRae, Philip",F,03/15/1990,"Chesterfield, Missouri",United States,15,1,2,3,2
"McReavy, Pat",F,01/16/1918,"Owen Sound, Ontario",Canada,55,5,8,13,4
"McReynolds, Brian",F,01/05/1965,"Penetanguishene, Ontario",Canada,30,1,5,6,8
"McSheffrey, Bryan",F,09/25/1952,"Ottawa, Ontario",Canada,90,13,7,20,44
"McSorley, Marty",D,05/18/1963,"Hamilton, Ontario",Canada,961,108,251,359,3381
"McSween, Don",D,06/09/1964,"Detroit, Michigan",United States,47,3,10,13,55
"McTaggart, Jim",D,03/31/1960,"Weyburn, Saskatchewan",Canada,71,3,10,13,205
"McTavish, Dale",F,02/28/1972,"Eganville, Ontario",Canada,9,1,2,3,2
"McTavish, Gord",F,06/03/1954,"Guelph, Ontario",Canada,11,1,3,4,2
"McTavish, Mason",F,01/30/2003,"Stittsville, Ontario",Canada,9,2,1,3,2
"McVeigh, Charley",F,03/29/1898,"Kenora, Ontario",Canada,395,84,89,173,132
"McVicar, Jack",D,06/04/1904,"Renfrew, Ontario",Canada,88,2,4,6,59
"McVicar, Robert",G,01/15/1982,"Brandon, Manitoba",Canada,1,0,0,0,0
"Meagher, Rick",F,11/02/1953,"Belleville, Ontario",Canada,691,144,165,309,383
"Medvedev, Evgeny",D,08/27/1982,Chelyabinsk,Russia,45,4,8,12,34
"Meech, Derek",D,04/21/1984,"Winnipeg, Manitoba",Canada,144,4,13,17,45
"Meehan, Gerry",F,09/03/1946,"Toronto, Ontario",Canada,670,180,243,423,111
"Meeke, Brent",D,04/10/1952,"Toronto, Ontario",Canada,75,9,22,31,8
"Meeker, Howie",F,11/04/1924,"Kitchener, Ontario",Canada,346,83,102,185,329
"Meeker, Mike",F,02/23/1958,"Kingston, Ontario",Canada,4,0,0,0,5
"Meeking, Harry",F,11/04/1894,"Kitchener, Ontario",Canada,64,19,13,32,68
"Megan, Wade",F,07/22/1990,"Canton, New York",United States,15,1,1,2,2
"Meger, Paul",F,02/17/1929,"Watrous, Saskatchewan",Canada,212,39,52,91,116
"Megna, Jaycob",D,12/10/1992,"Plantation, Florida",United States,87,3,10,13,30
"Megna, Jayson",F,02/01/1990,"Fort Lauderdale, Florida",United States,148,10,15,25,34
"Meier, Timo",F,10/08/1996,Baden,Switzerland,394,123,141,264,234
"Meighan, Ron",D,05/26/1963,"Montréal, Quebec",Canada,48,3,7,10,18
"Meissner, Barrie",F,07/26/1946,"Kindersley, Saskatchewan",Canada,6,0,1,1,4
"Meissner, Dick",F,01/06/1940,"Kindersley, Saskatchewan",Canada,171,11,15,26,37
"Melametsä, Anssi",F,06/21/1961,Jyväskylä,Finland,27,0,3,3,2
"Melanson, Dean",D,11/19/1973,"Antigonish, Nova Scotia",Canada,9,0,0,0,8
"Melanson, Rollie",G,06/28/1960,"Moncton, New Brunswick",Canada,291,0,12,12,109
"Melchiori, Julian",D,12/06/1991,"Richmond Hill, Ontario",Canada,30,0,2,2,8
"Melichar, Josef",D,01/20/1979,Ceske Budejovice,Czech Republic,349,7,42,49,300
"Melin, Björn",F,07/04/1981,Jönköping,Sweden,3,1,0,1,0
"Melin, Roger",F,04/25/1956,Enköping,Sweden,3,0,0,0,0
"Mellanby, Scott",F,06/11/1966,"Montréal, Quebec",Canada,1431,364,476,840,2479
"Mellor, Tom",D,01/27/1950,"Cranston, Rhode Island",United States,26,2,4,6,25
"Melnichuk, Alexei",G,06/29/1998,Saint Petersburg,Russia,3,0,0,0,0
"Melnyk, Gerry",F,09/16/1934,"Edmonton, Alberta",Canada,269,39,77,116,30
"Melnyk, Larry",D,02/21/1960,"Saskatoon, Saskatchewan",Canada,432,11,63,74,686
"Meloche, Eric",F,05/01/1976,"Montréal, Quebec",Canada,74,9,11,20,36
"Meloche, Gilles",G,07/12/1950,"Montréal, Quebec",Canada,788,0,22,22,109
"Meloche, Nicolas",D,07/18/1997,"LaSalle, Quebec",Canada,57,2,6,8,39
"Melrose, Barry",D,07/15/1956,"Kelvington, Saskatchewan",Canada,300,10,23,33,728
"Menard, Hillary",F,01/15/1934,"Timmins, Ontario",Canada,1,0,0,0,0
"Menard, Howie",F,04/28/1942,"Timmins, Ontario",Canada,151,23,42,65,87
"Menell, Brennan",D,05/24/1997,"Woodbury, Minnesota",United States,5,0,0,0,2
"Mercer, Dawson",F,10/27/2001,"Bay Roberts, Newfoundland and Labrador",Canada,82,17,25,42,28
"Mercier, Justin",F,06/25/1987,"Erie, Pennsylvania",United States,9,1,1,2,0
"Mercredi, Vic",F,03/31/1953,"Yellowknife, Northwest Territories",Canada,2,0,0,0,0
"Meredith, Greg",F,02/23/1958,"Toronto, Ontario",Canada,38,6,4,10,8
"Merkley, Nicholas",F,05/23/1997,"Calgary, Alberta",Canada,41,4,11,15,11
"Merkley, Ryan",D,08/14/2000,"Oakville, Ontario",Canada,39,1,5,6,8
"Merkosky, Glenn",F,04/08/1960,"Edmonton, Alberta",Canada,66,5,12,17,22
"Mermis, Dakota",D,01/05/1994,"Alton, Illinois",United States,25,1,3,4,4
"Meronek, Bill",F,04/15/1917,"Stony Mountain, Manitoba",Canada,20,5,8,13,0
"Merrick, Wayne",F,04/23/1952,"Sarnia, Ontario",Canada,774,191,265,456,303
"Merrill, Horace",D,11/30/1884,"Ottawa, Ontario",Canada,9,0,0,0,3
"Merrill, Jon",D,02/03/1992,"Oklahoma City, Oklahoma",United States,474,16,70,86,233
"Mersch, Michael",F,10/02/1992,"Park Ridge, Illinois",United States,17,1,2,3,0
"Mertzig, Jan",D,07/18/1970,Huddinge,Sweden,23,0,2,2,8
"Merzlikins, Elvis",G,04/13/1994,Riga,Latvia,119,0,3,3,8
"Messier, Eric",D,10/29/1973,"Drummondville, Quebec",Canada,406,25,50,75,146
"Messier, Joby",D,03/02/1970,"Regina, Saskatchewan",Canada,25,0,4,4,24
"Messier, Mark",F,01/18/1961,"Edmonton, Alberta",Canada,1756,694,1193,1887,1912
"Messier, Mitch",F,08/21/1965,"Regina, Saskatchewan",Canada,20,0,2,2,11
"Messier, Paul",F,01/27/1958,"Nottingham, England",United Kingdom,9,0,0,0,4
"Meszaros, Andrej",D,10/13/1985,Povazska Bystrica,Slovakia,645,63,175,238,457
"Metcalfe, Scott",F,01/06/1967,"Toronto, Ontario",Canada,19,1,2,3,18
"Mete, Victor",D,06/07/1998,"Toronto, Ontario",Canada,236,5,38,43,42
"Methot, Marc",D,06/21/1985,"Ottawa, Ontario",Canada,624,22,101,123,380
"Metropolit, Glen",F,06/25/1974,"Toronto, Ontario",Canada,407,57,102,159,148
"Metz, Don",F,01/10/1916,"Wilcox, Saskatchewan",Canada,170,20,35,55,42
"Metz, Nick",F,02/16/1914,"Wilcox, Saskatchewan",Canada,517,131,119,250,149
"Meyer, Carson",F,08/18/1997,"Powell, Ohio",United States,13,1,2,3,6
"Meyer, Freddy",D,01/04/1981,"Sanbornville, New Hampshire",United States,281,20,53,73,155
"Meyer, Stefan",F,07/20/1985,"Medicine Hat, Alberta",Canada,20,0,2,2,17
"Meyers, Ben",F,11/15/1998,"Delano, Minnesota",United States,5,1,0,1,0
"Mezei, Branislav",D,10/08/1980,Nitra,Slovakia,240,5,19,24,311
"Micalef, Corrado",G,04/20/1961,"Montréal, Quebec",Canada,113,0,5,5,43
"Michaelis, Marc",F,07/31/1995,Mannheim,Germany,15,0,0,0,2
"Michálek, Milan",F,12/07/1984,Jindrichuv Hradec,Czech Republic,747,208,238,446,394
"Michálek, Zbynek",D,12/23/1982,Jindrichuv Hradec,Czech Republic,784,42,136,178,322
"Michaluk, Art",D,05/04/1923,"Canmore, Alberta",Canada,5,0,0,0,0
"Michaluk, John",F,11/02/1928,"Canmore, Alberta",Canada,1,0,0,0,0
"Michaud, Alfie",G,11/06/1976,"Selkirk, Manitoba",Canada,2,0,0,0,0
"Michaud, Olivier",G,09/14/1983,"Beloeil, Quebec",Canada,1,0,0,0,0
"Michayluk, Dave",F,05/18/1962,"Wakaw, Saskatchewan",Canada,14,2,6,8,8
"Micheletti, Joe",D,10/24/1954,"International Falls, Minnesota",United States,158,11,60,71,114
"Micheletti, Patrick",F,12/11/1963,"Hibbing, Minnesota",United States,12,2,0,2,8
"Mickey, Larry",F,10/21/1943,"Lacombe, Alberta",Canada,292,39,53,92,160
"Mickoski, Nick",F,12/07/1927,"Winnipeg, Manitoba",Canada,705,158,185,343,315
"Middendorf, Max",F,08/18/1967,"Syracuse, New York",United States,13,2,4,6,6
"Middlebrook, Lindsay",G,09/07/1955,"Collingwood, Ontario",Canada,37,0,1,1,22
"Middleton, Jacob",D,01/02/1996,"Stratford, Ontario",Canada,80,4,13,17,95
"Middleton, Keaton",D,02/10/1998,"Edmonton, Alberta",Canada,3,0,0,0,4
"Middleton, Rick",F,12/04/1953,"Toronto, Ontario",Canada,1005,448,540,988,157
"Miehm, Kevin",F,09/10/1969,"Kitchener, Ontario",Canada,22,1,4,5,8
"Miele, Andy",F,04/15/1988,"Grosse Pointe Woods, Michigan",United States,15,0,2,2,11
"Miettinen, Antti",F,07/03/1980,Hämeenlinna,Finland,539,97,133,230,234
"Migay, Rudy",F,11/18/1928,"Thunder Bay, Ontario",Canada,417,59,92,151,293
"Mihalik, Vladimir",D,01/29/1987,Prešov,Slovakia,15,0,3,3,8
"Mika, Petr",F,02/12/1979,Prague,Czech Republic,3,0,0,0,0
"Mikheyev, Ilya",F,10/10/1994,Omsk,Russia,146,36,36,72,36
"Mikhnov, Alexei",F,08/31/1982,Kiev,Ukraine,2,0,0,0,0
"Mikita, Stan",F,05/20/1940,Sokol?e,Slovakia,1396,541,926,1467,1264
"Mikkelson, Bill",D,05/21/1948,"Neepawa, Manitoba",Canada,147,4,18,22,105
"Mikkelson, Brendan",D,06/22/1987,"Regina, Saskatchewan",Canada,131,1,9,10,59
"Mikkola, Niko",D,04/27/1996,Kiiminki,Finland,89,4,13,17,66
"Mikol, Jim",D,06/11/1938,"Kitchener, Ontario",Canada,34,1,4,5,8
"Mikulchik, Oleg",D,06/27/1964,Minsk,Belarus,37,0,3,3,33
"Milano, Sonny",F,05/12/1996,"Massapequa, New York",United States,197,36,45,81,46
"Milbury, Mike",D,06/17/1952,"Brighton, Massachusetts",United States,754,49,189,238,1552
"Milks, Hib",F,04/01/1899,"Eardley, Quebec",Canada,317,88,41,129,181
"Millar, Al",G,09/18/1929,"Winnipeg, Manitoba",Canada,6,0,0,0,0
"Millar, Craig",D,07/12/1976,"Winnipeg, Manitoba",Canada,114,8,14,22,73
"Millar, Hugh",D,04/03/1921,"Edmonton, Alberta",Canada,4,0,0,0,0
"Millar, Mike",F,04/28/1965,"St. Catharines, Ontario",Canada,78,18,18,36,12
"Millen, Corey",F,03/30/1964,"Cloquet, Minnesota",United States,335,90,119,209,236
"Millen, Greg",G,06/25/1957,"Toronto, Ontario",Canada,604,0,18,18,72
"Miller, Aaron",D,08/11/1971,"Buffalo, New York",United States,677,25,94,119,422
"Miller, Andrew",F,09/18/1988,"Bloomfield Hills, Michigan",United States,15,1,5,6,0
"Miller, Bill",F,08/01/1908,"Campbellton, New Brunswick",Canada,95,7,3,10,16
"Miller, Bob",F,09/28/1956,"Medford, Massachusetts",United States,404,75,119,194,220
"Miller, Brad",D,07/23/1969,"Edmonton, Alberta",Canada,82,1,5,6,321
"Miller, Colin",D,10/29/1992,"Sault Ste. Marie, Ontario",Canada,387,29,107,136,261
"Miller, Drew",F,02/17/1984,"Dover, New Jersey",United States,571,62,60,122,136
"Miller, Earl",F,09/12/1905,"Lumsden, Saskatchewan",Canada,110,19,14,33,130
"Miller, J.T.",F,03/14/1993,"East Palestine, Ohio",United States,637,169,285,454,323
"Miller, Jack",F,09/16/1925,"Delisle, Saskatchewan",Canada,17,0,0,0,4
"Miller, Jason",F,03/01/1971,"Edmonton, Alberta",Canada,6,0,0,0,0
"Miller, Jay",F,07/16/1960,"Wellesley, Massachusetts",United States,446,40,44,84,1723
"Miller, Joe",G,10/06/1900,"Morrisburg, Ontario",Canada,130,0,0,0,0
"Miller, K'Andre",D,01/21/2000,"Hopkins, Minnesota",United States,135,12,20,32,44
"Miller, Kelly",F,03/03/1963,"Lansing, Michigan",United States,1057,181,282,463,512
"Miller, Kevan",D,11/15/1987,"Los Angeles, California",United States,352,13,58,71,281
"Miller, Kevin",F,09/02/1965,"Lansing, Michigan",United States,620,150,185,335,429
"Miller, Kip",F,06/11/1969,"Lansing, Michigan",United States,449,74,165,239,105
"Miller, Paul",F,08/21/1959,"Billerica, Massachusetts",United States,3,0,3,3,0
"Miller, Perry",D,06/24/1952,"Winnipeg, Manitoba",Canada,217,10,51,61,387
"Miller, Ryan",G,07/17/1980,"East Lansing, Michigan",United States,796,0,12,12,48
"Miller, Tom",F,03/31/1947,"Kitchener, Ontario",Canada,118,16,25,41,34
"Miller, Warren",F,06/15/1953,"South St. Paul, Minnesota",United States,262,40,50,90,137
"Milley, Norm",F,02/14/1980,"Toronto, Ontario",Canada,29,2,4,6,12
"Mills, Bradley",F,05/03/1983,"Olds, Alberta",Canada,34,1,1,2,37
"Mills, Craig",F,08/27/1976,"Toronto, Ontario",Canada,31,0,5,5,36
"Milroy, Duncan",F,02/08/1983,"Edmonton, Alberta",Canada,5,0,1,1,0
"Minard, Christopher",F,11/18/1981,"Owen Sound, Ontario",Canada,40,2,4,6,14
"Minard, Mike",G,11/01/1976,"Owen Sound, Ontario",Canada,1,0,0,0,0
"Miner, John",D,08/28/1965,"Moose Jaw, Saskatchewan",Canada,14,2,3,5,16
"Mink, Graham",F,05/21/1979,"Stowe, Vermont",United States,7,0,0,0,2
"Minor, Gerry",F,10/27/1958,"Regina, Saskatchewan",Canada,140,11,21,32,173
"Mio, Eddie",G,01/31/1954,"Windsor, Ontario",Canada,192,0,11,11,32
"Miromanov, Daniil",F,07/11/1997,Moscow,Russia,11,0,1,1,2
"Mironov, Andrei",D,07/29/1994,Moscow,Russia,10,1,2,3,12
"Mironov, Boris",D,03/21/1972,Moscow,Russia,716,76,231,307,891
"Mironov, Dmitri",D,12/25/1965,Moscow,Russia,556,54,206,260,568
"Miska, Hunter",G,07/07/1995,"Stacy, Minnesota",United States,6,0,0,0,0
"Miszuk, John",D,09/29/1940,Naliboki,Belarus,237,7,39,46,232
"Mitchell, Bill",D,02/22/1930,"Port Dalhousie, Ontario",Canada,1,0,0,0,0
"Mitchell, Bill 'Red'",D,09/06/1912,"Toronto, Ontario",Canada,83,4,5,9,67
"Mitchell, Garrett",F,09/02/1991,"Regina, Saskatchewan",Canada,1,0,0,0,0
"Mitchell, Herb",F,01/04/1896,"Meaford, Ontario",Canada,55,6,2,8,60
"Mitchell, Ian",D,01/18/1999,"St. Albert, Alberta",Canada,47,3,5,8,14
"Mitchell, Jeff",F,05/16/1975,"Wayne, Michigan",United States,7,0,0,0,7
"Mitchell, John",F,01/22/1985,"Oakville, Ontario",Canada,548,70,107,177,267
"Mitchell, Mike",G,07/09/1893,"Winnipeg, Manitoba",Canada,22,0,0,0,0
"Mitchell, Roy",D,03/14/1969,"Edmonton, Alberta",Canada,3,0,0,0,0
"Mitchell, Torrey",F,01/30/1985,"Greenfield Park, Quebec",Canada,666,67,85,152,351
"Mitchell, Willie",D,04/23/1977,"Port McNeill, British Columbia",Canada,907,34,146,180,787
"Mitchell, Zack",F,01/07/1993,"Caledon, Ontario",Canada,34,3,2,5,4
"Mittelstadt, Casey",F,11/22/1998,"Edina, Minnesota",United States,195,33,47,80,28
"Modano, Mike",F,06/07/1970,"Livonia, Michigan",United States,1499,561,813,1374,926
"Modin, Fredrik",F,10/08/1974,Sundsvall,Sweden,898,232,230,462,453
"Modrý, Jaroslav",D,02/27/1971,Ceske Budejovice,Czech Republic,725,49,201,250,510
"Moe, Bill",D,10/02/1916,"Danvers, Massachusetts",United States,261,11,42,53,163
"Moen, Travis",F,04/06/1982,"Swift Current, Saskatchewan",Canada,747,59,77,136,801
"Moffat, Lyle",F,03/19/1948,"Calgary, Alberta",Canada,97,12,16,28,51
"Moffat, Mike",G,02/04/1962,"Galt, Ontario",Canada,18,0,0,0,2
"Moffatt, Ron",F,08/21/1905,"West Hope, North Dakota",United States,37,1,1,2,8
"Moger, Sandy",F,03/21/1969,"100 Mile House, British Columbia",Canada,236,41,38,79,212
"Mogilny, Alexander",F,02/18/1969,Khabarovsk,Russia,990,473,559,1032,432
"Moher, Mike",F,03/26/1962,"Manitouwadge, Ontario",Canada,9,0,1,1,28
"Mohns, Doug",D,12/13/1933,"Capreol, Ontario",Canada,1391,248,462,710,1261
"Mohns, Lloyd",D,07/31/1921,"Petawawa, Ontario",Canada,1,0,0,0,0
"Mojzis, Tomas",D,05/02/1982,Kolin,Czech Republic,17,1,2,3,14
"Mokosak, Carl",F,09/22/1962,"Fort Saskatchewan, Alberta",Canada,83,11,15,26,170
"Mokosak, John",D,09/07/1963,"Edmonton, Alberta",Canada,41,0,2,2,96
"Molin, Lars",F,05/07/1956,Örnsköldsvik,Sweden,172,33,65,98,37
"Molino, Griffen",F,01/21/1994,"Trenton, Michigan",United States,5,0,0,0,0
"Moller, Mike",F,06/16/1962,"Calgary, Alberta",Canada,134,15,28,43,41
"Möller, Oscar",F,01/22/1989,Stockholm,Sweden,87,12,14,26,22
"Moller, Randy",D,08/23/1963,"Red Deer, Alberta",Canada,815,45,180,225,1692
"Molloy, Mitch",F,10/10/1966,"Red Lake, Ontario",Canada,2,0,0,0,10
"Molyneaux, Larry",D,07/09/1912,"Sutton West, Ontario",Canada,45,0,1,1,20
"Momesso, Sergio",F,09/04/1965,"Montréal, Quebec",Canada,710,152,193,345,1557
"Monahan, Garry",F,10/20/1946,"Barrie, Ontario",Canada,748,116,169,285,486
"Monahan, Hartland",F,03/29/1951,"Montréal, Quebec",Canada,334,61,80,141,163
"Monahan, Sean",F,10/12/1994,"Brampton, Ontario",Canada,656,212,250,462,153
"Mondou, Armand",F,06/27/1905,"Yamaska, Quebec",Canada,386,47,71,118,101
"Mondou, Pierre",F,11/27/1955,"Sorel-Tracy, Quebec",Canada,548,194,262,456,179
"Mongeau, Michel",F,02/09/1965,"Montréal, Quebec",Canada,54,6,19,25,10
"Mongrain, Bob",F,08/31/1959,"La Sarre, Quebec",Canada,81,13,14,27,14
"Montador, Steve",D,12/21/1979,"Vancouver, British Columbia",Canada,571,33,98,131,807
"Monteith, Hank",F,10/02/1945,"Stratford, Ontario",Canada,77,5,12,17,6
"Montembeault, Samuel",G,10/30/1996,"Québec City, Quebec",Canada,63,0,1,1,0
"Montgomery, Jim",F,06/30/1969,"Montréal, Quebec",Canada,122,9,25,34,80
"Montour, Brandon",D,04/11/1994,"Brantford, Ontario",Canada,374,42,104,146,228
"Montoya, Al",G,02/13/1985,"Chicago, Illinois",United States,168,0,5,5,12
"Moog, Andy",G,02/18/1960,"Penticton, British Columbia",Canada,713,0,24,24,230
"Moore, Alfie",G,12/01/1905,"Toronto, Ontario",Canada,21,0,0,0,0
"Moore, Barrie",F,05/22/1975,"London, Ontario",Canada,39,2,6,8,18
"Moore, Dickie",F,01/06/1931,"Montréal, Quebec",Canada,719,261,346,607,646
"Moore, Dominic",F,08/03/1980,"Thornhill, Ontario",Canada,897,106,176,282,487
"Moore, Greg",F,03/26/1984,"Lisbon, Maine",United States,10,0,0,0,0
"Moore, John",D,11/19/1990,"Winnetka, Illinois",United States,544,38,80,118,227
"Moore, Mike",D,12/12/1984,"Calgary, Alberta",Canada,6,1,0,1,7
"Moore, Robbie",G,05/03/1954,"Sarnia, Ontario",Canada,6,0,1,1,0
"Moore, Steve",F,09/22/1978,"Windsor, Ontario",Canada,69,5,7,12,41
"Moore, Trevor",F,03/31/1995,"Thousand Oaks, California",United States,204,35,54,89,46
"Moran, Amby",D,04/03/1895,"Winnipeg, Manitoba",Canada,35,1,1,2,24
"Moran, Brad",F,03/20/1979,"Abbotsford, British Columbia",Canada,8,1,2,3,4
"Moran, Ian",D,08/24/1972,"Cleveland, Ohio",United States,489,21,50,71,321
"Moravec, David",F,03/24/1973,Vitkovice,Czech Republic,1,0,0,0,0
"More, Jayson",D,01/12/1969,"Souris, Manitoba",Canada,406,18,54,72,702
"Moreau, Ethan",F,09/22/1975,"Huntsville, Ontario",Canada,928,147,140,287,1110
"Morenz, Howie",F,09/21/1902,"Mitchell, Ontario",Canada,550,271,205,476,562
"Moretto, Angie",F,09/18/1953,"Toronto, Ontario",Canada,5,1,2,3,2
"Morgan, Gavin",F,07/09/1976,"Scarborough, Ontario",Canada,6,0,0,0,21
"Morgan, Jason",F,10/09/1976,"St. John's, Newfoundland and Labrador",Canada,44,2,5,7,18
"Morin, Jeremy",F,04/16/1991,"Auburn, New York",United States,82,10,12,22,69
"Morin, Pete",F,12/08/1915,"Lachine, Quebec",Canada,32,10,12,22,7
"Morin, Samuel",D,07/12/1995,"Lac-Beauport, Quebec",Canada,29,1,0,1,45
"Morin, Stephane",F,03/27/1969,"Montréal, Quebec",Canada,90,16,39,55,52
"Morin, Travis",F,01/09/1984,"Minneapolis, Minnesota",United States,13,0,1,1,0
"Morisset, David",F,04/06/1981,"Langley, British Columbia",Canada,4,0,0,0,5
"Morissette, Dave",F,12/24/1971,"Baie-Comeau, Quebec",Canada,11,0,0,0,57
"Morissette, Jean-Guy",G,12/16/1937,"Causapscal, Quebec",Canada,1,0,0,0,0
"Mormina, Joey",D,06/29/1982,"Montréal, Quebec",Canada,1,0,0,0,0
"Moro, Marc",D,07/17/1977,"Toronto, Ontario",Canada,30,0,0,0,77
"Morozov, Alexei",F,02/16/1977,Moscow,Russia,451,84,135,219,98
"Morris, Bernie",F,08/21/1890,"Brandon, Manitoba",Canada,6,1,1,2,0
"Morris, Derek",D,08/24/1978,"Edmonton, Alberta",Canada,1107,92,332,424,1004
"Morris, Elwin 'Moe'",D,01/03/1921,"Toronto, Ontario",Canada,135,14,29,43,56
"Morris, Jon",F,05/06/1966,"Lowell, Massachusetts",United States,103,16,33,49,47
"Morrison, Brendan",F,08/15/1975,"Pitt Meadows, British Columbia",Canada,934,200,401,601,452
"Morrison, Dave",F,06/12/1962,"Toronto, Ontario",Canada,39,3,3,6,4
"Morrison, Don",F,07/14/1923,"Saskatoon, Saskatchewan",Canada,112,18,28,46,12
"Morrison, Doug",F,02/01/1960,"Vancouver, British Columbia",Canada,23,7,3,10,15
"Morrison, Gary",F,11/08/1955,"Farmington, Michigan",United States,43,1,15,16,70
"Morrison, George",F,12/24/1948,"Toronto, Ontario",Canada,115,17,21,38,13
"Morrison, Jim",D,10/11/1931,"Montréal, Quebec",Canada,704,40,161,201,545
"Morrison, John",F,03/04/1895,"Selkirk, Manitoba",Canada,18,0,1,1,0
"Morrison, Kevin",D,10/28/1949,"Sydney, Nova Scotia",Canada,41,4,11,15,23
"Morrison, Lew",F,02/11/1948,"Gainsborough, Saskatchewan",Canada,564,39,52,91,107
"Morrison, Mark",F,05/11/1963,"Prince George, British Columbia",Canada,10,1,1,2,0
"Morrison, Mike",G,07/11/1979,"Medford, Massachusetts",United States,29,0,1,1,2
"Morrison, Rod",F,10/07/1925,"Saskatoon, Saskatchewan",Canada,34,8,7,15,4
"Morrisonn, Shaone",D,12/23/1982,"Vancouver, British Columbia",Canada,480,11,64,75,455
"Morrissey, Josh",D,03/28/1995,"Calgary, Alberta",Canada,423,40,126,166,214
"Morrow, Brenden",F,01/16/1979,"Carlyle, Saskatchewan",Canada,991,265,310,575,1362
"Morrow, Joe",D,12/09/1992,"Sherwood Park, Alberta",Canada,162,9,23,32,62
"Morrow, Ken",D,10/17/1956,"Flint, Michigan",United States,550,17,88,105,309
"Morrow, Scott",F,06/18/1969,"Chicago, Illinois",United States,4,0,0,0,0
"Morton, Dean",D,02/27/1968,"Peterborough, Ontario",Canada,1,1,0,1,2
"Mortson, Gus",D,01/24/1925,"New Liskeard, Ontario",Canada,797,46,152,198,1378
"Mosdell, Kenny",F,07/13/1922,"Montréal, Quebec",Canada,694,141,168,309,473
"Moser, J.J.",D,06/06/2000,Zuchwil,Switzerland,43,4,11,15,16
"Moser, Simon",F,03/10/1989,Bern,Switzerland,6,1,1,2,2
"Mosienko, Bill",F,11/02/1921,"Winnipeg, Manitoba",Canada,711,258,282,540,133
"Moss, David",F,12/28/1981,"Dearborn, Michigan",United States,501,78,100,178,157
"Moss, Tyler",G,06/29/1975,"Ottawa, Ontario",Canada,30,0,1,1,0
"Motin, Johan",D,10/10/1989,Karlskoga,Sweden,1,0,0,0,0
"Mott, Morris",F,05/25/1946,"Creelman, Saskatchewan",Canada,199,18,32,50,49
"Mottau, Mike",D,03/19/1978,"Quincy, Massachusetts",United States,321,7,51,58,164
"Motte, Tyler",F,03/10/1995,"St. Clair, Michigan",United States,269,35,27,62,76
"Motter, Alex",F,06/20/1913,"Melville, Saskatchewan",Canada,266,39,64,103,135
"Motzko, Joe",F,03/14/1980,"Bemidji, Minnesota",United States,25,4,2,6,0
"Mouillierat, Kael",F,12/09/1987,"Edmonton, Alberta",Canada,7,1,1,2,10
"Moulson, Matt",F,11/01/1983,"North York, Ontario",Canada,650,176,193,369,122
"Moverare, Jacob",D,08/31/1998,Östersund,Sweden,19,0,2,2,2
"Mowers, Johnny",G,10/29/1916,"Niagara Falls, Ontario",Canada,152,0,0,0,2
"Mowers, Mark",F,02/16/1974,"Decatur, Georgia",United States,278,18,44,62,70
"Moxey, Jim",F,05/28/1953,"Toronto, Ontario",Canada,127,22,27,49,59
"Mozik, Vojtech",D,12/26/1992,Prague,Czech Republic,7,0,0,0,4
"Mrazek, Jerome",G,10/15/1951,"Prince Albert, Saskatchewan",Canada,1,0,0,0,0
"Mrazek, Petr",G,02/14/1992,Ostrava,Czech Republic,295,0,3,3,14
"Mrozik, Rick",D,01/02/1975,"Duluth, Minnesota",United States,2,0,0,0,0
"Muckalt, Bill",F,07/15/1974,"Surrey, British Columbia",Canada,256,40,57,97,204
"Mueller, Chris",F,03/06/1986,"West Seneca, New York",United States,53,3,7,10,8
"Mueller, Peter",F,04/14/1988,"Bloomington, Minnesota",United States,297,63,97,160,98
"Muir, Bryan",D,06/08/1973,"Winnipeg, Manitoba",Canada,279,16,37,53,281
"Mulhern, Richard",D,03/01/1955,"Edmonton, Alberta",Canada,303,27,93,120,217
"Mulhern, Ryan",F,01/11/1973,"Philadelphia, Pennsylvania",United States,3,0,0,0,0
"Mullen, Brian",F,03/16/1962,"New York, New York",United States,832,260,362,622,416
"Mullen, Joe",F,02/26/1957,"New York, New York",United States,1062,502,561,1063,241
"Muller, Kirk",F,02/08/1966,"Kingston, Ontario",Canada,1349,357,602,959,1228
"Müller, Marcel",F,07/10/1988,Berlin,Germany,3,0,0,0,2
"Müller, Mirco",D,03/21/1995,Winterthur,Switzerland,185,5,23,28,61
"Muloin, Wayne",D,12/24/1941,"Dryden, Ontario",Canada,145,3,21,24,93
"Mulvenna, Glenn",F,02/18/1967,"Calgary, Alberta",Canada,2,0,0,0,4
"Mulvey, Grant",F,09/17/1956,"Sudbury, Ontario",Canada,586,149,135,284,816
"Mulvey, Paul",F,09/27/1958,"Sudbury, Ontario",Canada,225,30,51,81,613
"Mummery, Harry",D,08/25/1889,"Chicago, Illinois",United States,106,32,20,52,225
"Muni, Craig",D,07/19/1962,"Toronto, Ontario",Canada,819,28,119,147,775
"Munro, Adam",G,11/12/1982,"St. George, Ontario",Canada,17,0,1,1,2
"Munro, Dunc",D,01/19/1901,"Moray, Scotland",United Kingdom,239,28,18,46,179
"Munro, Gerald",D,11/28/1897,"Sault Ste. Marie, Ontario",Canada,34,1,2,3,32
"Murdoch, Bob",D,11/20/1946,"Kirkland Lake, Ontario",Canada,757,60,218,278,764
"Murdoch, Bob",F,01/29/1954,"Cranbrook, British Columbia",Canada,260,72,85,157,127
"Murdoch, Don",F,10/25/1956,"Cranbrook, British Columbia",Canada,320,121,117,238,155
"Murdoch, Murray",F,05/19/1904,"Lucknow, Ontario",Canada,508,84,104,188,193
"Murley, Matt",F,12/17/1979,"Troy, New York",United States,62,2,7,9,38
"Murphy, Brian",F,08/20/1947,"Toronto, Ontario",Canada,1,0,0,0,0
"Murphy, Connor",D,03/26/1993,"Dublin, Ohio",United States,551,32,88,120,328
"Murphy, Cory",D,02/13/1978,"Kanata, Ontario",Canada,91,9,27,36,38
"Murphy, Curtis",D,12/03/1975,"Kerrobert, Saskatchewan",Canada,1,0,0,0,0
"Murphy, Gord",D,03/23/1967,"Willowdale, Ontario",Canada,862,85,238,323,668
"Murphy, Hal",G,07/06/1927,"Montréal, Quebec",Canada,1,0,0,0,0
"Murphy, Joe",F,10/16/1967,"London, Ontario",Canada,779,233,295,528,810
"Murphy, Larry",D,03/08/1961,"Scarborough, Ontario",Canada,1615,288,929,1217,1084
"Murphy, Mike",G,01/15/1989,"Kingston, Ontario",Canada,2,0,0,0,0
"Murphy, Mike",F,09/12/1950,"Toronto, Ontario",Canada,831,238,318,556,514
"Murphy, Rob",F,04/07/1969,"Hull, Quebec",Canada,125,9,12,21,152
"Murphy, Ron",F,04/10/1933,"Hamilton, Ontario",Canada,889,205,274,479,456
"Murphy, Ryan",D,03/31/1993,"Aurora, Ontario",Canada,175,8,35,43,54
"Murphy, Trevor",D,07/17/1995,"Windsor, Ontario",Canada,8,1,2,3,0
"Murray, Al",D,11/10/1908,"Stratford, Ontario",Canada,271,5,9,14,163
"Murray, Andrew",F,11/06/1981,"Selkirk, Manitoba",Canada,221,24,16,40,36
"Murray, Bob",D,11/26/1954,"Kingston, Ontario",Canada,1008,132,382,514,873
"Murray, Bob",D,07/16/1948,"Peterborough, Ontario",Canada,194,6,16,22,98
"Murray, Brady",F,08/17/1984,"Brandon, Manitoba",Canada,4,1,0,1,6
"Murray, Brett",F,07/20/1998,"Bolton, Ontario",Canada,21,2,4,6,23
"Murray, Chris",F,10/25/1974,"Port Hardy, British Columbia",Canada,242,16,18,34,550
"Murray, Doug",D,03/12/1980,Bromma,Sweden,518,7,57,64,412
"Murray, Garth",F,09/17/1982,"Regina, Saskatchewan",Canada,116,8,2,10,131
"Murray, Glen",F,11/01/1972,"Halifax, Nova Scotia",Canada,1009,337,314,651,679
"Murray, Jim",D,11/25/1943,"Virden, Manitoba",Canada,30,0,2,2,14
"Murray, Ken",D,01/22/1948,"Toronto, Ontario",Canada,106,1,10,11,135
"Murray, Leo",F,02/15/1906,"Portage la Prairie, Manitoba",Canada,6,0,0,0,2
"Murray, Marty",F,02/16/1975,"Deloraine, Manitoba",Canada,261,31,42,73,41
"Murray, Matt",G,05/25/1994,"Thunder Bay, Ontario",Canada,246,0,5,5,10
"Murray, Mickey",G,10/14/1898,"Peterborough, Ontario",Canada,1,0,0,0,0
"Murray, Mike",F,08/29/1966,"Kingston, Ontario",Canada,1,0,0,0,0
"Murray, Pat",F,08/20/1969,"Stratford, Ontario",Canada,25,3,1,4,15
"Murray, Randy",D,08/24/1945,"Chatham, Ontario",Canada,3,0,0,0,2
"Murray, Rem",F,10/09/1972,"Stratford, Ontario",Canada,560,94,121,215,161
"Murray, Rob",F,04/04/1967,"Toronto, Ontario",Canada,107,4,15,19,111
"Murray, Ryan",D,09/27/1993,"White City, Saskatchewan",Canada,432,15,113,128,114
"Murray, Terry",D,07/20/1950,"Shawville, Quebec",Canada,303,4,76,80,199
"Murray, Troy",F,07/31/1962,"Calgary, Alberta",Canada,915,230,354,584,875
"Mursak, Jan",F,01/20/1988,Maribor,Slovenia,46,2,2,4,8
"Murzyn, Dana",D,12/09/1966,"Calgary, Alberta",Canada,838,52,152,204,1571
"Musil, David",D,04/09/1993,"Edmonton, Alberta",Canada,4,0,2,2,2
"Musil, Frantisek",D,12/17/1964,Pardubice,Czech Republic,797,34,106,140,1241
"Muzzatti, Jason",G,02/03/1970,"Toronto, Ontario",Canada,62,0,1,1,61
"Muzzin, Jake",D,02/21/1989,"Woodstock, Ontario",Canada,679,69,224,293,397
"Myers, Hap",D,07/28/1947,"Edmonton, Alberta",Canada,13,0,0,0,6
"Myers, Philippe",D,01/25/1997,"Moncton, New Brunswick",Canada,142,7,26,33,66
"Myers, Tyler",D,02/01/1990,"Houston, Texas",United States,840,87,238,325,634
"Myhres, Brantt",F,03/18/1974,"Edmonton, Alberta",Canada,154,6,2,8,687
"Myles, Vic",D,11/12/1915,"Fairlight, Saskatchewan",Canada,45,6,8,14,57
"Myllys, Jarmo",G,05/29/1965,Savonlinna,Finland,39,0,1,1,4
"Mylnikov, Sergei",G,10/06/1958,Chelyabinsk,Russia,10,0,0,0,0
"Myre, Phil",G,11/01/1948,"Sainte-Anne-de-Bellevue, Quebec",Canada,439,0,10,10,99
"Myrvold, Anders",D,08/12/1975,Lørenskog,Norway,33,0,5,5,12
"Nabokov, Dmitri",F,01/04/1977,Novosibirsk,Russia,55,11,13,24,28
"Nabokov, Evgeni",G,07/25/1975,Ust-Kamenogorsk,Kazakhstan,697,1,15,16,118
"Nachbaur, Don",F,01/30/1959,"Kitimat, British Columbia",Canada,223,23,46,69,465
"Nagy, Ladislav",F,06/01/1979,Saca,Slovakia,435,115,196,311,358
"Nahrgang, Jim",D,04/17/1951,"Millbank, Ontario",Canada,57,5,12,17,34
"Nakladal, Jakub",D,12/30/1987,Hradec Kralove,Czech Republic,30,2,3,5,6
"Namestnikov, Evgeny",D,10/09/1971,Novgorod,Russia,43,0,9,9,24
"Namestnikov, Vladislav",F,11/22/1992,Nizhny Novgorod,Russia,553,107,129,236,296
"Nanne, Lou",D,06/02/1941,"Sault Ste. Marie, Ontario",Canada,635,68,157,225,356
"Nantais, Richard",F,10/27/1954,"Repentigny, Quebec",Canada,63,5,4,9,79
"Napier, Mark",F,01/28/1957,"Toronto, Ontario",Canada,767,235,306,541,157
"Nash, Brendon",D,03/31/1987,"Calgary, Alberta",Canada,2,0,0,0,0
"Nash, Rick",F,06/16/1984,"Brampton, Ontario",Canada,1060,437,368,805,750
"Nash, Riley",F,05/09/1989,"Consort, Alberta",Canada,627,63,113,176,144
"Nash, Tyson",F,03/11/1975,"Edmonton, Alberta",Canada,374,27,37,64,673
"Näslund, Markus",F,07/30/1973,Örnsköldsvik,Sweden,1117,395,474,869,736
"Näslund, Mats",F,10/31/1959,Timrå,Sweden,651,251,383,634,111
"Nasreddine, Alain",D,07/10/1975,"Montréal, Quebec",Canada,74,1,4,5,84
"Nättinen, Joonas",F,01/03/1991,Jämsä,Finland,1,0,0,0,0
"Nattrass, Ralph",D,05/26/1925,"Gainsborough, Saskatchewan",Canada,223,18,38,56,308
"Nattress, Ric",D,05/25/1962,"Hamilton, Ontario",Canada,536,29,135,164,377
"Natyshak, Mike",F,11/29/1963,"Belle River, Ontario",Canada,4,0,0,0,0
"Naumenko, Gregg",G,03/30/1977,"Chicago, Illinois",United States,2,0,0,0,2
"Nazarov, Andrei",F,05/22/1974,Chelyabinsk,Russia,571,53,71,124,1409
"Ndur, Rumun",D,07/07/1975,Zaria,Nigeria,69,2,3,5,137
"Neal, James",F,09/03/1987,"Whitby, Ontario",Canada,869,296,263,559,581
"Neaton, Pat",D,05/21/1971,"Redford, Michigan",United States,9,1,1,2,12
"Necas, Martin",F,01/15/1999,Nove Mesto na Morave,Czech Republic,203,45,74,119,64
"Nechayev, Victor",F,01/28/1955,Belogorsk,Russia,3,1,0,1,0
"Neckár, Stanislav",D,12/22/1975,Ceske Budejovice,Czech Republic,510,12,41,53,316
"Nedeljkovic, Alexander",G,01/07/1996,"Parma, Ohio",United States,88,0,3,3,6
"Nedomanský, Václav",F,03/14/1944,Hodonin,Czech Republic,421,122,156,278,88
"Nedorost, Andrej",F,04/30/1980,Trencín,Slovakia,28,2,3,5,12
"Nedorost, Václav",F,03/16/1982,Ceske Budejovice,Czech Republic,99,10,10,20,34
"Nedved, Petr",F,12/09/1971,Liberec,Czech Republic,982,310,407,717,708
"Nedved, Zdenek",F,03/03/1975,Lany,Czech Republic,31,4,6,10,14
"Needham, Mike",F,04/04/1970,"Calgary, Alberta",Canada,86,9,5,14,16
"Neely, Bob",F,11/09/1953,"Sarnia, Ontario",Canada,283,39,59,98,266
"Neely, Cam",F,06/06/1965,"Comox, British Columbia",Canada,726,395,299,694,1241
"Negrin, John",D,03/25/1989,"West Vancouver, British Columbia",Canada,3,0,1,1,2
"Neighbours, Jake",F,03/29/2002,"Airdrie, Alberta",Canada,9,1,1,2,2
"Neil, Chris",F,06/18/1979,"Markdale, Ontario",Canada,1026,112,138,250,2522
"Neilson, Jim",D,11/28/1940,"Big River, Saskatchewan",Canada,1024,69,299,368,901
"Nelson, Brock",F,10/15/1991,"Warroad, Minnesota",United States,676,205,182,387,252
"Nelson, Casey",D,07/18/1992,"Stillwater, Minnesota",United States,93,4,14,18,33
"Nelson, Gordie",D,05/10/1947,"Kinistino, Saskatchewan",Canada,3,0,0,0,11
"Nelson, Jeff",F,12/18/1972,"Prince Albert, Saskatchewan",Canada,52,3,8,11,20
"Nelson, Todd",D,05/11/1969,"Prince Albert, Saskatchewan",Canada,3,1,0,1,2
"Nemchinov, Sergei",F,01/14/1964,Moscow,Russia,761,152,193,345,251
"Nemecek, Jan",D,02/14/1976,Pisek,Czech Republic,7,1,0,1,4
"Nemeth, Patrik",D,02/08/1992,Stockholm,Sweden,429,10,55,65,210
"Nemeth, Steve",F,02/11/1967,"Calgary, Alberta",Canada,12,2,0,2,2
"Nemirovsky, David",F,08/01/1976,"Toronto, Ontario",Canada,91,16,22,38,42
"Nemisz, Greg",F,06/05/1990,"Courtice, Ontario",Canada,15,0,1,1,0
"Ness, Aaron",D,05/18/1990,"Roseau, Minnesota",United States,72,1,6,7,22
"Nesterenko, Eric",F,10/31/1933,"Flin Flon, Manitoba",Canada,1219,250,324,574,1275
"Nesterov, Nikita",D,03/28/1993,Chelyabinsk,Russia,170,9,28,37,101
"Nestrasil, Andrej",F,02/22/1991,Prague,Czech Republic,128,17,31,48,18
"Nethery, Lance",F,06/28/1957,"Toronto, Ontario",Canada,41,11,14,25,14
"Neufeld, Ray",F,04/15/1959,"St. Boniface, Manitoba",Canada,595,157,200,357,816
"Neuvirth, Michal",G,03/23/1988,Usti nad Labem,Czech Republic,256,0,4,4,6
"Neville, Mike",F,10/11/1904,"Grand-Mere, Quebec",Canada,67,5,6,11,14
"Nevin, Bob",F,03/18/1938,"Timmins, Ontario",Canada,1128,307,419,726,215
"Newberry, John",F,04/08/1962,"Port Alberni, British Columbia",Canada,22,0,4,4,6
"Newbury, Kris",F,02/19/1982,"Brampton, Ontario",Canada,76,4,6,10,139
"Newell, Rick",D,02/18/1948,"Winnipeg, Manitoba",Canada,7,0,0,0,0
"Newhook, Alex",F,01/28/2001,"St. John's, Newfoundland and Labrador",Canada,77,13,23,36,14
"Newman, Dan",F,01/26/1952,"Windsor, Ontario",Canada,126,17,24,41,63
"Newman, John",D,04/24/1910,"Ottawa, Ontario",Canada,9,1,1,2,2
"Newton, Cam",G,02/25/1950,"Peterborough, Ontario",Canada,16,0,1,1,6
"Nichol, Scott",F,12/31/1974,"Edmonton, Alberta",Canada,662,56,71,127,916
"Nicholls, Bernie",F,06/24/1961,"Haliburton, Ontario",Canada,1127,475,734,1209,1292
"Nicholson, Al",F,04/26/1936,"Estevan, Saskatchewan",Canada,19,0,1,1,2
"Nicholson, Edward",D,09/09/1923,"Portsmouth, Ontario",Canada,1,0,0,0,0
"Nicholson, Hickey",F,09/09/1911,"Charlottetown, Prince Edward Island",Canada,2,1,0,1,0
"Nicholson, Neil",D,09/12/1949,"Saint John, New Brunswick",Canada,39,3,1,4,23
"Nicholson, Paul",F,02/16/1954,"London, Ontario",Canada,62,4,8,12,18
"Nichushkin, Valeri",F,03/04/1995,Chelyabinsk,Russia,405,71,103,174,54
"Nickulas, Eric",F,03/25/1975,"Hyannis, Massachusetts",United States,118,15,23,38,82
"Nicolson, Graeme",D,01/13/1958,"North Bay, Ontario",Canada,52,2,7,9,60
"Nieckar, Barry",F,12/16/1967,"Rama, Saskatchewan",Canada,8,0,0,0,21
"Niedermayer, Rob",F,12/28/1974,"Cassiar, British Columbia",Canada,1153,186,283,469,904
"Niedermayer, Scott",D,08/31/1973,"Edmonton, Alberta",Canada,1263,172,568,740,784
"Niederreiter, Nino",F,09/08/1992,Chur,Switzerland,732,181,187,368,352
"Niekamp, Jim",D,03/11/1946,"Detroit, Michigan",United States,29,0,2,2,37
"Nielsen, Chris",F,02/16/1980,Moshi,Tanzania,52,6,8,14,8
"Nielsen, Frans",F,04/24/1984,Herning,Denmark,925,167,306,473,166
"Nielsen, Jeff",F,09/20/1971,"Grand Rapids, Minnesota",United States,252,20,27,47,70
"Nielsen, Kirk",F,10/19/1973,"Grand Rapids, Minnesota",United States,6,0,0,0,0
"Niemeläinen, Markus",D,06/08/1998,Kuopio,Finland,20,0,1,1,4
"Niemi, Antti",G,08/29/1983,Vantaa,Finland,464,0,12,12,8
"Niemi, Antti-Jussi",D,09/22/1977,Vantaa,Finland,29,1,1,2,22
"Nieminen, Ville",F,04/06/1977,Tampere,Finland,385,48,69,117,333
"Nienhuis, Kraig",F,05/09/1961,"Sarnia, Ontario",Canada,87,20,16,36,39
"Nieto, Matthew",F,11/05/1992,"Long Beach, California",United States,570,73,102,175,105
"Nieuwendyk, Joe",F,09/10/1966,"Oshawa, Ontario",Canada,1257,564,562,1126,677
"Nieves, Cristoval",F,01/23/1994,"Baldwinsville, New York",United States,76,5,14,19,24
"Nighbor, Frank",F,01/26/1893,"Pembroke, Ontario",Canada,349,139,100,239,266
"Nigro, Frank",F,02/11/1960,"Richmond Hill, Ontario",Canada,68,8,18,26,41
"Nihlstorp, Cristopher",G,02/16/1984,Malmö,Sweden,6,0,0,0,0
"Niinimaa, Janne",D,05/22/1975,Raahe,Finland,741,54,265,319,733
"Niittymäki, Antero",G,06/18/1980,Turku,Finland,234,0,3,3,6
"Nikitin, Nikita",D,06/16/1986,Omsk,Russia,259,17,59,76,85
"Nikolishin, Andrei",F,03/25/1973,Vorkuta,Russia,628,93,187,280,270
"Niku, Sami",D,10/10/1996,Haapavesi,Finland,67,2,14,16,24
"Nikulin, Alexander",F,08/25/1985,Perm,Russia,3,0,0,0,0
"Nilan, Chris",F,02/09/1958,"Boston, Massachusetts",United States,688,110,115,225,3043
"Nill, Jim",F,04/11/1958,"Hanna, Alberta",Canada,524,58,87,145,854
"Nilson, Marcus",F,03/01/1978,Bålsta,Sweden,521,67,101,168,270
"Nilsson, Anders",G,03/19/1990,Luleå,Sweden,161,0,3,3,6
"Nilsson, Jacob",F,10/12/1993,Mörrum,Sweden,2,0,0,0,0
"Nilsson, Kent",F,08/31/1956,Nynäshamn,Sweden,553,264,422,686,116
"Nilsson, Robert",F,01/10/1985,"Calgary, Alberta",Canada,252,37,81,118,90
"Nilsson, Ulf",F,05/11/1950,Nynäshamn,Sweden,170,57,112,169,85
"Niskala, Janne",D,09/22/1981,Västerås,Sweden,6,1,2,3,6
"Niskanen, Matt",D,12/06/1986,"Virginia, Minnesota",United States,949,72,284,356,489
"Nistico, Lou",F,01/25/1953,"Thunder Bay, Ontario",Canada,3,0,0,0,6
"Noble, Reg",F,06/23/1896,"Collingwood, Ontario",Canada,510,167,106,273,925
"Nödl, Andreas",F,02/28/1987,Vienna,Austria,183,15,21,36,28
"Noel, Claude",F,10/31/1955,"Kirkland Lake, Ontario",Canada,7,0,0,0,0
"Noesen, Stefan",F,02/12/1993,"Plano, Texas",United States,207,31,23,54,122
"Nogier, Nelson",D,05/27/1996,"Saskatoon, Saskatchewan",Canada,11,0,0,0,5
"Nokelainen, Petteri",F,01/16/1986,Imatra,Finland,245,20,21,41,103
"Nolan, Brandon",F,07/18/1983,"St. Catharines, Ontario",Canada,6,0,1,1,0
"Nolan, Jordan",F,06/23/1989,"St. Catharines, Ontario",Canada,375,24,28,52,347
"Nolan, Owen",F,02/12/1972,"Belfast, Northern Ireland",United Kingdom,1200,422,463,885,1793
"Nolan, Paddy",F,12/01/1897,"Charlottetown, Prince Edward Island",Canada,2,0,0,0,0
"Nolan, Ted",F,04/07/1958,"Sault Ste. Marie, Ontario",Canada,78,6,16,22,105
"Nolet, Simon",F,11/23/1941,"Saint-Odilon, Quebec",Canada,562,150,182,332,187
"Noonan, Brian",F,05/29/1965,"Boston, Massachusetts",United States,629,116,159,275,518
"Nordgren, Niklas",F,06/28/1979,Örnsköldsvik,Sweden,58,4,2,6,34
"Nordmark, Robert",D,08/20/1962,Luleå,Sweden,236,13,70,83,254
"Nordqvist, Jonas",F,04/26/1982,Leksand,Sweden,3,0,2,2,2
"Nordström, Joakim",F,02/25/1992,Stockholm,Sweden,444,32,43,75,77
"Nordström, Peter",F,07/26/1974,Munkfors,Sweden,2,0,0,0,0
"Noreau, Maxim",D,05/24/1987,"Montréal, Quebec",Canada,6,0,0,0,0
"Noris, Joe",D,10/26/1951,"Denver, Colorado",United States,55,2,5,7,22
"Norlinder, Mattias",D,04/12/2000,Kramfors,Sweden,6,0,1,1,2
"Noronen, Mika",G,06/17/1979,Tampere,Finland,71,1,0,1,4
"Norrena, Fredrik",G,11/29/1973,Pietarsaari,Finland,100,0,1,1,6
"Norris, Dwayne",F,01/08/1970,"St. John's, Newfoundland and Labrador",Canada,20,2,4,6,8
"Norris, Jack",G,08/05/1942,"Saskatoon, Saskatchewan",Canada,58,0,0,0,0
"Norris, Joshua",F,05/05/1999,"Oxford, Michigan",United States,125,52,38,90,29
"Norrish, Rod",F,11/27/1951,"Saskatoon, Saskatchewan",Canada,21,3,3,6,2
"Norström, Mattias",D,01/02/1972,Stockholm,Sweden,903,18,147,165,661
"Northcott, Baldy",F,09/07/1908,"Calgary, Alberta",Canada,448,133,112,245,271
"Norton, Brad",D,02/13/1975,"Cambridge, Massachusetts",United States,124,3,8,11,287
"Norton, Jeff",D,11/25/1965,"Acton, Massachusetts",United States,799,52,332,384,615
"Norwich, Craig",D,12/15/1955,"Edina, Minnesota",United States,104,17,58,75,60
"Norwood, Lee",D,02/02/1960,"Oakland, California",United States,503,58,153,211,1099
"Nosek, Tomas",F,09/01/1992,Pardubice,Czech Republic,332,35,48,83,98
"Novák, Filip",D,05/07/1982,Ceske Budejovice,Czech Republic,17,0,0,0,6
"Novak, Thomas",F,04/28/1997,"River Falls, Wisconsin",United States,27,1,6,7,2
"Novoseltsev, Ivan",F,01/23/1979,Golitsyno,Russia,234,31,44,75,112
"Novotný, Jirí",F,08/12/1983,Pelhrimov,Czech Republic,189,20,31,51,66
"Nový, Milan",F,09/23/1951,Kladno,Czech Republic,73,18,30,48,16
"Nowak, Hank",F,11/24/1950,"Oshawa, Ontario",Canada,180,26,29,55,161
"Nugent-Hopkins, Ryan",F,04/12/1993,"Burnaby, British Columbia",Canada,719,196,332,528,239
"Nummelin, Petteri",D,11/25/1972,Turku,Finland,139,9,36,45,34
"Numminen, Teppo",D,07/03/1968,Tampere,Finland,1372,117,520,637,513
"Nurminen, Kai",F,03/29/1969,Turku,Finland,69,17,11,28,24
"Nurminen, Pasi",G,12/17/1975,Lahti,Finland,125,0,5,5,37
"Nurse, Darnell",D,02/04/1995,"Hamilton, Ontario",Canada,477,54,138,192,406
"Nutivaara, Markus",D,06/06/1994,Oulu,Finland,275,17,54,71,42
"Nycholat, Lawrence",D,05/07/1979,"Calgary, Alberta",Canada,50,2,7,9,24
"Nygård, Joakim",F,01/08/1993,Stockholm,Sweden,42,3,6,9,12
"Nykoluk, Mike",F,12/11/1934,"Toronto, Ontario",Canada,32,3,1,4,20
"Nylander, Alexander",F,03/02/1998,"Calgary, Alberta",Canada,84,13,19,32,14
"Nylander, Michael",F,10/03/1972,Stockholm,Sweden,920,209,470,679,468
"Nylander, William",F,05/01/1996,"Calgary, Alberta",Canada,439,137,206,343,106
"Nylund, Gary",D,10/28/1963,"Surrey, British Columbia",Canada,608,32,139,171,1235
"Nyquist, Gustav",F,09/01/1989,Halmstad,Sweden,652,164,237,401,170
"Nyrop, Bill",D,07/23/1952,"Washington, District of Columbia",United States,207,12,51,63,101
"Nystrom, Bobby",F,10/10/1952,Stockholm,Sweden,900,235,278,513,1248
"Nystrom, Eric",F,02/14/1983,"Syosset, New York",United States,593,75,48,123,401
"O'Brien, Dennis",D,06/10/1949,"Port Hope, Ontario",Canada,592,31,91,122,1017
"O'Brien, Doug",D,02/16/1984,"St. John's, Newfoundland and Labrador",Canada,5,0,0,0,2
"O'Brien, Ellard",F,05/27/1930,"St. Catharines, Ontario",Canada,2,0,0,0,0
"O'Brien, Jim",F,01/29/1989,"Maplewood, Minnesota",United States,77,8,5,13,16
"O'Brien, Liam",F,07/29/1994,"Halifax, Nova Scotia",Canada,68,3,5,8,174
"O'Brien, Shane",D,08/09/1983,"Port Hope, Ontario",Canada,537,13,79,92,916
"O'Byrne, Ryan",D,07/19/1984,"Victoria, British Columbia",Canada,308,5,34,39,369
"O'Callahan, Jack",D,07/24/1957,"Charlestown, Massachusetts",United States,389,27,104,131,541
"O'Connell, Mike",D,11/25/1955,"Chicago, Illinois",United States,860,105,335,440,605
"O'Connor, Buddy",F,06/21/1916,"Montréal, Quebec",Canada,509,140,257,397,34
"O'Connor, Drew",F,06/09/1998,"Morristown, New Jersey",United States,32,3,3,6,6
"O'Connor, Logan",F,08/14/1996,"Calgary, Alberta",Canada,124,13,18,31,46
"O'Connor, Matthew",G,02/14/1992,"Sault Ste. Marie, Ontario",Canada,1,0,0,0,0
"O'Connor, Myles",D,04/02/1967,"Calgary, Alberta",Canada,43,3,4,7,69
"O'Dell, Eric",F,06/21/1990,"Ottawa, Ontario",Canada,41,3,5,8,29
"O'Donnell, Fred",F,12/06/1949,"Kingston, Ontario",Canada,115,15,11,26,98
"O'Donnell, Sean",D,10/13/1971,"Ottawa, Ontario",Canada,1224,31,198,229,1809
"O'Donoghue, Don",F,08/27/1949,"Kingston, Ontario",Canada,125,18,17,35,35
"O'Dwyer, Bill",F,01/25/1960,"Boston, Massachusetts",United States,120,9,13,22,108
"O'Flaherty, Gerry",F,08/31/1950,"Pittsburgh, Pennsylvania",United States,438,99,95,194,168
"O'Flaherty, Peanuts",F,04/10/1918,"Toronto, Ontario",Canada,21,5,1,6,0
"O'Gara, Rob",D,07/06/1993,"Nesconset, New York",United States,33,0,3,3,6
"O'Grady, George",F,06/08/1892,"Montréal, Quebec",Canada,4,0,0,0,0
"O'Marra, Ryan",F,06/09/1987,Tokyo,Japan,33,1,6,7,17
"O'Neil, Paul",F,08/24/1953,"Charlestown, Massachusetts",United States,6,0,0,0,0
"O'Neill, Brian",F,06/01/1988,"Yardley, Pennsylvania",United States,22,0,2,2,8
"O'Neill, Jeff",F,02/23/1976,"Richmond Hill, Ontario",Canada,821,237,259,496,670
"O'Neill, Jim Peggy",F,04/03/1913,"Semans, Saskatchewan",Canada,156,6,30,36,109
"O'Neill, Mike",G,11/03/1967,"LaSalle, Quebec",Canada,21,0,0,0,0
"O'Neill, Tom",F,09/28/1923,"Deseronto, Ontario",Canada,66,10,12,22,53
"O'Neill, Wes",D,03/03/1986,"Windsor, Ontario",Canada,5,0,0,0,6
"O'Neill, Will",D,04/28/1988,"Salem, Massachusetts",United States,1,0,0,0,0
"O'Ree, Willie",F,10/15/1935,"Fredericton, New Brunswick",Canada,45,4,10,14,26
"O'Regan, Danny",F,01/30/1994,Berlin,Germany,30,1,5,6,2
"O'Regan, Thomas",F,12/29/1961,"Cambridge, Massachusetts",United States,61,5,12,17,10
"O'Reilly, Cal",F,09/30/1986,"Toronto, Ontario",Canada,145,16,33,49,14
"O'Reilly, Ryan",F,02/07/1991,"Clinton, Ontario",Canada,938,240,432,672,136
"O'Reilly, Terry",F,06/07/1951,"Niagara Falls, Ontario",Canada,891,204,402,606,2095
"O'Shea, Danny",F,06/15/1945,"Toronto, Ontario",Canada,369,64,115,179,267
"O'Shea, Kevin",F,05/28/1947,"Toronto, Ontario",Canada,134,13,18,31,85
"O'Sullivan, Chris",D,05/15/1974,"Dorchester, Massachusetts",United States,62,2,17,19,16
"O'Sullivan, Patrick",F,02/01/1985,"Toronto, Ontario",Canada,334,58,103,161,116
"Oates, Adam",F,08/27/1962,"Weston, Ontario",Canada,1337,341,1079,1420,415
"Oatman, Russell",F,02/19/1905,"Tillsonburg, Ontario",Canada,120,20,9,29,98
"Oberg, Evan",D,02/16/1988,"Forestburg, Alberta",Canada,7,0,0,0,0
"Obsut, Jaroslav",D,03/09/1976,Prešov,Slovakia,7,0,0,0,2
"Oddleifson, Chris",F,09/07/1950,"Brandon, Manitoba",Canada,524,95,191,286,464
"Odelein, Lyle",D,07/21/1968,"Quill Lake, Saskatchewan",Canada,1056,50,202,252,2316
"Odelein, Selmar",D,04/11/1966,"Quill Lake, Saskatchewan",Canada,18,0,2,2,35
"Odgers, Jeff",F,05/31/1969,"Spy Hill, Saskatchewan",Canada,821,75,70,145,2364
"Odjick, Gino",F,09/07/1970,"Maniwaki, Quebec",Canada,605,64,73,137,2567
"Odrowski, Gerry",D,10/04/1938,"Trout Creek, Ontario",Canada,309,12,19,31,111
"Oduya, Johnny",D,10/01/1981,Stockholm,Sweden,850,41,149,190,372
"Oesterle, Jordan",D,06/25/1992,"Dearborn Heights, Michigan",United States,297,17,56,73,48
"Oettinger, Jake",G,12/18/1998,"Lakeville, Minnesota",United States,77,0,3,3,4
"Ogilvie, Brian",F,01/30/1952,"Stettler, Alberta",Canada,90,15,21,36,29
"Ogrodnick, John",F,06/20/1959,"Ottawa, Ontario",Canada,928,402,425,827,260
"Öhlund, Mattias",D,09/09/1976,Piteå,Sweden,909,93,250,343,885
"Ojanen, Janne",F,04/09/1968,Tampere,Finland,98,21,23,44,28
"Okerlund, Todd",F,09/06/1964,"Burnsville, Minnesota",United States,4,0,0,0,2
"Okhotyuk, Nikita",D,12/04/2000,Chelyabinsk,Russia,5,1,1,2,2
"Okposo, Kyle",F,04/16/1988,"St. Paul, Minnesota",United States,909,219,345,564,486
"Oksiuta, Roman",F,08/21/1970,Murmansk,Russia,153,46,41,87,100
"Olausson, Fredrik",D,10/05/1966,Dädesjö,Sweden,1022,147,434,581,452
"Olczyk, Ed",F,08/16/1966,"Chicago, Illinois",United States,1031,342,452,794,874
"Oleksiak, Jamie",D,12/21/1992,"Toronto, Ontario",Canada,441,25,64,89,344
"Oleksy, Steve",D,02/04/1986,"Chesterfield, Michigan",United States,73,3,17,20,110
"Oleschuk, Bill",G,07/20/1955,"Edmonton, Alberta",Canada,55,0,0,0,14
"Olesevich, Dan",G,09/16/1937,"Port Colborne, Ontario",Canada,1,0,0,0,0
"Olesz, Rostislav",F,10/10/1985,Bilovec,Czech Republic,365,57,77,134,118
"Oliver, David",F,04/17/1971,"Sechelt, British Columbia",Canada,233,49,49,98,84
"Oliver, Harry",F,10/26/1898,"Selkirk, Manitoba",Canada,465,127,85,212,147
"Oliver, Murray",F,11/14/1937,"Hamilton, Ontario",Canada,1127,274,454,728,315
"Olivier, Mathieu",F,02/11/1997,"Lévis, Quebec",Canada,48,3,4,7,88
"Oliwa, Krzysztof",F,04/12/1973,Tychy,Poland,410,17,28,45,1447
"Olmstead, Bert",F,09/04/1926,"Sceptre, Saskatchewan",Canada,848,181,421,602,887
"Olofsson, Gustav",D,12/01/1994,Borås,Sweden,59,0,11,11,18
"Olofsson, Victor",F,07/18/1995,Örnsköldsvik,Sweden,188,55,72,127,20
"Olsen, Darryl",D,10/07/1966,"Calgary, Alberta",Canada,1,0,0,0,0
"Olsen, Dylan",D,01/03/1991,"Salt Lake City, Utah",United States,124,5,17,22,36
"Olson, Dennis",F,11/09/1934,"Kenora, Ontario",Canada,3,0,0,0,0
"Olson, Josh",F,07/13/1981,"Grand Forks, North Dakota",United States,5,1,0,1,0
"Olsson, Christer",D,07/24/1970,Arboga,Sweden,56,4,12,16,24
"Olvecky, Peter",F,10/11/1985,Nove Zámky,Slovakia,32,2,5,7,12
"Olver, Mark",F,01/01/1988,"Burnaby, British Columbia",Canada,74,10,12,22,39
"Ölvestad, Jimmie",F,02/16/1980,Stockholm,Sweden,111,3,14,17,40
"Omark, Linus",F,02/05/1987,Övertorneå,Sweden,79,8,24,32,40
"Ondrus, Ben",F,06/25/1982,"Sherwood Park, Alberta",Canada,52,0,2,2,77
"Orban, Bill",F,02/20/1944,"Regina, Saskatchewan",Canada,114,8,15,23,67
"Oreskovic, Phil",D,01/26/1987,"North York, Ontario",Canada,10,1,1,2,21
"Oreskovich, Victor",F,08/15/1986,"Whitby, Ontario",Canada,67,2,7,9,41
"Orlando, Gates",F,11/13/1962,"Montréal, Quebec",Canada,98,18,26,44,51
"Orlando, Jimmy",D,02/27/1916,"Montréal, Quebec",Canada,199,6,25,31,415
"Orleski, Dave",F,12/26/1959,"Edmonton, Alberta",Canada,2,0,0,0,0
"Orlov, Dmitry",D,07/23/1991,Novokuznetsk,Russia,643,57,180,237,269
"Orpik, Brooks",D,09/26/1980,"San Francisco, California",United States,1035,18,176,194,972
"Orr, Bobby",D,03/20/1948,"Parry Sound, Ontario",Canada,657,270,645,915,953
"Orr, Colton",F,03/03/1982,"Winnipeg, Manitoba",Canada,477,12,12,24,1186
"Orszagh, Vladimir",F,05/24/1977,Banska Bystrica,Slovakia,289,54,65,119,194
"Ortio, Joni",G,04/16/1991,Turku,Finland,37,0,2,2,2
"Ortmeyer, Jed",F,09/03/1978,"Omaha, Nebraska",United States,345,22,31,53,161
"Osala, Oskar",F,12/26/1987,Vaasa,Finland,3,0,0,0,0
"Osborne, Keith",F,04/02/1969,"Toronto, Ontario",Canada,16,1,3,4,16
"Osborne, Mark",F,08/13/1961,"Toronto, Ontario",Canada,919,212,319,531,1152
"Osburn, Randy",F,11/26/1952,"Collingwood, Ontario",Canada,27,0,2,2,0
"Osgood, Chris",G,11/26/1972,"Peace River, Alberta",Canada,744,1,19,20,137
"Oshie, T.J.",F,12/23/1986,"Mt. Vernon, Washington",United States,900,271,364,635,438
"Osiecki, Mark",D,07/23/1968,"St. Paul, Minnesota",United States,93,3,11,14,43
"Otevrel, Jaroslav",F,09/16/1968,Zlin,Czech Republic,16,3,4,7,2
"Ott, Steve",F,08/19/1982,"Summerside, Prince Edward Island",Canada,848,109,179,288,1555
"Otto, Joel",F,10/29/1961,"Elk River, Minnesota",United States,943,195,313,508,1934
"Ouellet, Maxime",G,06/17/1981,"Beauport, Quebec",Canada,12,0,1,1,2
"Ouellet, Michel",F,03/05/1982,"Rimouski, Quebec",Canada,190,52,64,116,58
"Ouellet, Xavier",D,07/29/1993,Bayonne,France,178,5,23,28,82
"Ouellette, Eddie",F,03/09/1911,"Ottawa, Ontario",Canada,43,3,2,5,11
"Ouellette, Gerry",F,11/01/1938,"Grand Falls, New Brunswick",Canada,35,5,4,9,0
"Ouimet, Ted",G,07/06/1947,"Rouyn-Noranda, Quebec",Canada,1,0,0,0,0
"Ovechkin, Alexander",F,09/17/1985,Moscow,Russia,1274,780,630,1410,749
"Owchar, Dennis",D,03/28/1953,"Dryden, Ontario",Canada,288,30,85,115,200
"Owen, George",D,02/12/1901,"Hamilton, Ontario",Canada,183,44,33,77,151
"Oystrick, Nathan",D,12/17/1982,"Regina, Saskatchewan",Canada,65,5,10,15,61
"Ozhiganov, Igor",D,10/13/1992,Krasnogorsk,Russia,53,3,4,7,14
"Ozolinsh, Sandis",D,08/03/1972,Sigulda,Latvia,875,167,397,564,638
"Pääjärvi, Magnus",F,04/12/1991,Norrköping,Sweden,467,62,62,124,78
"Pachal, Brayden",D,08/23/1999,"Estevan, Saskatchewan",Canada,2,0,0,0,0
"Pachal, Clayton",F,04/21/1956,"Yorkton, Saskatchewan",Canada,35,2,3,5,95
"Pacioretty, Max",F,11/20/1988,"New Canaan, Connecticut",United States,850,323,319,642,466
"Paddock, Cam",F,03/22/1983,"North Vancouver, British Columbia",Canada,16,2,1,3,0
"Paddock, John",F,06/09/1954,"Brandon, Manitoba",Canada,87,8,14,22,86
"Paek, Jim",D,04/07/1967,Seoul,South Korea,217,5,29,34,155
"Paetsch, Nathan",D,03/30/1983,"Leroy, Saskatchewan",Canada,167,7,35,42,114
"Pageau, Jean-Gabriel",F,11/11/1992,"Ottawa, Ontario",Canada,566,121,130,251,210
"Pageau, Paul",G,10/01/1959,"Montréal, Quebec",Canada,1,0,0,0,0
"Påhlsson, Samuel",F,12/17/1977,Ånge,Sweden,798,68,131,199,356
"Paiement, Rosaire",F,08/12/1945,"Earlton, Ontario",Canada,191,48,52,100,343
"Paiement, Wilf",F,10/16/1955,"Earlton, Ontario",Canada,946,356,458,814,1759
"Paille, Daniel",F,04/15/1984,"Welland, Ontario",Canada,582,85,87,172,135
"Paille, Marcel",G,12/08/1932,"Shawinigan, Quebec",Canada,107,0,1,1,2
"Pakarinen, Iiro",F,08/25/1991,Suonenjoki,Finland,134,10,13,23,18
"Palangio, Peter",F,09/10/1908,"North Bay, Ontario",Canada,71,13,10,23,28
"Palat, Ondrej",F,03/28/1991,Frydek-Mistek,Czech Republic,628,143,280,423,197
"Palazzari, Aldo",F,07/25/1918,"Eveleth, Minnesota",United States,35,8,3,11,4
"Palazzari, Doug",F,11/03/1952,"Eveleth, Minnesota",United States,108,18,20,38,23
"Palffy, Zigmund",F,05/05/1972,Skalica,Slovakia,684,329,384,713,322
"Paliotta, Michael",D,04/16/1993,"Westport, Connecticut",United States,2,0,1,1,4
"Palmateer, Mike",G,01/13/1954,"Toronto, Ontario",Canada,356,0,25,25,118
"Palmer, Brad",F,09/14/1961,"Duncan, British Columbia",Canada,168,32,38,70,58
"Palmer, Jarod",F,02/10/1986,"Fridley, Minnesota",United States,6,1,0,1,4
"Palmer, Rob",F,10/02/1952,"Detroit, Michigan",United States,16,0,3,3,2
"Palmer, Rob",D,09/10/1956,"Sarnia, Ontario",Canada,320,9,101,110,115
"Palmieri, Kyle",F,02/01/1991,"Smithtown, New York",United States,681,200,192,392,365
"Palmieri, Nick",F,07/12/1989,"Utica, New York",United States,87,13,12,25,20
"Palushaj, Aaron",F,09/07/1989,"Livonia, Michigan",United States,68,3,11,14,18
"Panagabko, Ed",F,05/17/1934,"Norquay, Saskatchewan",Canada,29,0,3,3,38
"Panarin, Artemi",F,10/30/1991,Korkino,Russia,508,187,382,569,146
"Pandolfo, Jay",F,12/27/1974,"Winchester, Massachusetts",United States,899,100,126,226,164
"Pandolfo, Mike",F,09/15/1979,"Winchester, Massachusetts",United States,3,0,0,0,0
"Pang, Darren",G,02/17/1964,"Meaford, Ontario",Canada,81,0,9,9,6
"Panik, Richard",F,02/07/1991,Martin,Slovakia,521,88,107,195,274
"Pankewicz, Greg",F,11/06/1970,"Drayton Valley, Alberta",Canada,21,0,3,3,22
"Pantelejevs, Grigorijs",F,11/13/1972,Gastello,Russia,54,8,6,14,12
"Papike, Joe",F,03/28/1915,"Eveleth, Minnesota",United States,20,3,3,6,4
"Papineau, Justin",F,01/15/1980,"Ottawa, Ontario",Canada,81,11,8,19,12
"Pappin, Jim",F,09/10/1939,"Sudbury, Ontario",Canada,767,278,295,573,667
"Paquette, Cedric",F,08/13/1993,"Gaspé, Quebec",Canada,448,51,44,95,391
"Paradise, Bob",D,04/22/1944,"St. Paul, Minnesota",United States,368,8,54,62,393
"Parayko, Colton",D,05/12/1993,"St. Albert, Alberta",Canada,498,47,159,206,137
"Pardy, Adam",D,03/29/1984,"Bonavista, Newfoundland and Labrador",Canada,342,4,48,52,269
"Parent, Bernie",G,04/03/1945,"Montréal, Quebec",Canada,608,0,12,12,116
"Parent, Bob",G,02/19/1958,"Windsor, Ontario",Canada,3,0,0,0,0
"Parent, Rich",G,01/12/1973,"Montréal, Quebec",Canada,32,0,0,0,4
"Parent, Ryan",D,03/17/1987,"Prince Albert, Saskatchewan",Canada,106,1,6,7,36
"Parenteau, Pierre",F,03/24/1983,"Hull, Quebec",Canada,491,114,182,296,342
"Pargeter, George",F,02/24/1923,"Calgary, Alberta",Canada,4,0,0,0,0
"Parise, Jean-Paul",F,12/11/1941,"Smooth Rock Falls, Ontario",Canada,890,238,356,594,706
"Parise, Zach",F,07/28/1984,"Minneapolis, Minnesota",United States,1142,408,437,845,412
"Parizeau, Michel",F,04/09/1948,"Montréal, Quebec",Canada,58,3,14,17,18
"Park, Brad",D,07/06/1948,"Toronto, Ontario",Canada,1113,213,683,896,1429
"Park, Richard",F,05/27/1976,Seoul,South Korea,738,102,139,241,266
"Parker, Jeff",F,09/07/1964,"St. Paul, Minnesota",United States,141,16,19,35,163
"Parker, Scott",F,01/29/1978,"Hanford, California",United States,308,7,14,21,699
"Parkes, Ernie",F,11/04/1898,"Dunnville, Ontario",Canada,17,0,0,0,2
"Parks, Greg",F,03/25/1967,"Edmonton, Alberta",Canada,23,1,2,3,6
"Parrish, Mark",F,02/02/1977,"Bloomington, Minnesota",United States,722,216,171,387,246
"Parro, Dave",G,04/30/1957,"Saskatoon, Saskatchewan",Canada,77,0,2,2,6
"Parros, George",F,12/29/1979,"Washington, Pennsylvania",United States,474,18,18,36,1092
"Parse, Scott",F,09/05/1984,"Kalamazoo, Michigan",United States,73,14,16,30,36
"Parsons, George",F,06/28/1914,"Toronto, Ontario",Canada,78,12,13,25,20
"Pärssinen, Timo",F,01/17/1977,Lohja,Finland,17,0,3,3,2
"Pasek, Dusan",F,09/07/1960,Bratislava,Slovakia,48,4,10,14,30
"Pasichnuk, Brinson",D,11/24/1997,"Bonnyville, Alberta",Canada,4,0,0,0,2
"Pasin, Dave",F,07/08/1966,"Edmonton, Alberta",Canada,76,18,19,37,50
"Paslawski, Greg",F,08/25/1961,"Kindersley, Saskatchewan",Canada,650,187,185,372,169
"Pasquale, Eddie",G,11/20/1990,"Toronto, Ontario",Canada,3,0,0,0,0
"Passmore, Steve",G,01/29/1973,"Thunder Bay, Ontario",Canada,93,0,2,2,21
"Pastrnak, David",F,05/25/1996,Havirov,Czech Republic,510,240,264,504,215
"Patera, Pavel",F,09/06/1971,Kladno,Czech Republic,32,2,7,9,8
"Paterson, Joe",F,06/25/1960,"Toronto, Ontario",Canada,291,19,37,56,831
"Paterson, Mark",D,02/22/1964,"Ottawa, Ontario",Canada,29,3,3,6,33
"Paterson, Rick",F,02/10/1958,"Kingston, Ontario",Canada,430,50,43,93,136
"Pateryn, Greg",D,06/20/1990,"Sterling Heights, Michigan",United States,290,5,39,44,178
"Patey, Doug",F,12/28/1956,"Toronto, Ontario",Canada,45,4,2,6,8
"Patey, Larry",F,03/19/1953,"Toronto, Ontario",Canada,717,153,163,316,631
"Patrick, Craig",F,05/20/1946,"Detroit, Michigan",United States,401,72,91,163,61
"Patrick, Glenn",D,04/26/1950,"New York, New York",United States,38,2,3,5,72
"Patrick, James",D,06/14/1963,"Winnipeg, Manitoba",Canada,1280,149,490,639,759
"Patrick, Lester",G,12/30/1883,"Drummondville, Quebec",Canada,1,0,0,0,2
"Patrick, Lynn",F,02/03/1912,"Victoria, British Columbia",Canada,455,145,191,336,240
"Patrick, Muzz",D,06/28/1915,"Victoria, British Columbia",Canada,164,5,26,31,139
"Patrick, Nolan",F,09/19/1998,"Winnipeg, Manitoba",Canada,222,32,45,77,83
"Patrick, Steve",F,02/04/1961,"Winnipeg, Manitoba",Canada,250,40,68,108,242
"Patterson, Colin",F,05/11/1960,"Rexdale, Ontario",Canada,504,96,109,205,241
"Patterson, Dennis",D,01/09/1950,"Peterborough, Ontario",Canada,138,6,22,28,67
"Patterson, Ed",F,11/14/1972,"Delta, British Columbia",Canada,68,3,3,6,56
"Patterson, George",F,05/22/1906,"Kingston, Ontario",Canada,270,51,27,78,220
"Pätzold, Dmitri",G,02/03/1983,Ust-Kamenogorsk,Kazakhstan,3,0,0,0,0
"Paul, Arthur 'Butch'",F,09/11/1943,"Rocky Mountain House, Alberta",Canada,3,0,0,0,0
"Paul, Jeff",D,03/01/1978,"London, Ontario",Canada,2,0,0,0,7
"Paul, Nick",F,03/20/1995,"Mississauga, Ontario",Canada,248,34,46,80,92
"Paulhus, Roland",D,09/01/1902,"Sorel-Tracy, Quebec",Canada,33,0,0,0,0
"Pavelec, Ondrej",G,08/31/1987,Kladno,Czech Republic,398,0,6,6,12
"Pavelich, Mark",F,02/28/1958,"Eveleth, Minnesota",United States,355,137,192,329,340
"Pavelich, Marty",F,11/06/1927,"Sault Ste. Marie, Ontario",Canada,633,93,159,252,454
"Pavelski, Joe",F,07/11/1984,"Plover, Wisconsin",United States,1168,421,503,924,430
"Pavese, Jim",D,05/08/1962,"New York, New York",United States,328,13,44,57,689
"Payer, Evariste",F,12/12/1887,"Rockland, Ontario",Canada,1,0,0,0,0
"Payer, Serge",F,05/07/1979,"Rockland, Ontario",Canada,124,7,6,13,49
"Payerl, Adam",F,03/04/1991,"Kitchener, Ontario",Canada,2,0,0,0,2
"Payne, Davis",F,09/24/1970,"Port Alberni, British Columbia",Canada,22,0,1,1,14
"Payne, Steve",F,08/16/1958,"Toronto, Ontario",Canada,613,228,238,466,435
"Paynter, Kent",D,04/17/1965,"Summerside, Prince Edward Island",Canada,37,1,3,4,69
"Peake, Pat",F,05/28/1973,"Rochester, Michigan",United States,134,28,41,69,105
"Pearson, Chase",F,08/23/1997,"Alpharetta, Georgia",United States,3,0,0,0,0
"Pearson, Mel",F,04/29/1938,"Flin Flon, Manitoba",Canada,38,2,6,8,23
"Pearson, Rob",F,03/08/1971,"Oshawa, Ontario",Canada,269,56,54,110,645
"Pearson, Scott",F,12/19/1969,"Cornwall, Ontario",Canada,292,56,42,98,615
"Pearson, Tanner",F,08/10/1992,"Kitchener, Ontario",Canada,576,132,135,267,188
"Peat, Stephen",F,03/10/1980,"Princeton, British Columbia",Canada,130,8,2,10,234
"Peca, Matthew",F,04/27/1993,"Petawawa, Ontario",Canada,83,6,15,21,6
"Peca, Mike",F,03/26/1974,"Toronto, Ontario",Canada,864,176,289,465,798
"Pechurski, Alexander",G,06/04/1990,Magnitogorsk,Russia,1,0,0,0,0
"Peckham, Theo",D,11/10/1987,"Richmond Hill, Ontario",Canada,160,4,13,17,388
"Pedan, Andrei",D,07/03/1993,Kaunas,Lithuania,13,0,0,0,18
"Pedersen, Allen",D,01/13/1965,"Fort Saskatchewan, Alberta",Canada,428,5,36,41,487
"Pederson, Barry",F,03/13/1961,"Big River, Saskatchewan",Canada,701,238,416,654,472
"Pederson, Denis",F,09/10/1975,"Prince Albert, Saskatchewan",Canada,435,57,71,128,398
"Pederson, Lane",F,08/04/1997,"Saskatoon, Saskatchewan",Canada,44,1,4,5,12
"Pederson, Mark",F,01/14/1968,"Prelate, Saskatchewan",Canada,169,35,50,85,77
"Pederson, Tom",D,01/14/1970,"Bloomington, Minnesota",United States,240,20,49,69,142
"Peeke, Andrew",D,03/17/1998,"Parkland, Florida",United States,115,3,18,21,68
"Peer, Bert",F,11/12/1910,"Port Credit, Ontario",Canada,1,0,0,0,0
"Peeters, Pete",G,08/17/1957,"Edmonton, Alberta",Canada,489,0,14,14,177
"Peirson, Johnny",F,07/21/1925,"Winnipeg, Manitoba",Canada,544,153,173,326,309
"Pelech, Adam",D,08/16/1994,"Toronto, Ontario",Canada,381,19,84,103,138
"Pelech, Matt",D,09/04/1987,"Toronto, Ontario",Canada,13,1,3,4,38
"Pelensky, Perry",F,05/22/1962,"Edmonton, Alberta",Canada,4,0,0,0,5
"Pellerin, Scott",F,01/09/1970,"Shediac, New Brunswick",Canada,536,72,126,198,320
"Pelletier, Jean-Marc",G,03/04/1978,"Atlanta, Georgia",United States,7,0,0,0,0
"Pelletier, Marcel",G,12/06/1927,"Drummondville, Quebec",Canada,8,0,0,0,2
"Pelletier, Pascal",F,06/16/1983,"Labrador City, Newfoundland and Labrador",Canada,16,0,0,0,0
"Pelletier, Roger",D,06/22/1945,"Montréal, Quebec",Canada,1,0,0,0,0
"Pelley, Rod",F,09/01/1984,"Kitimat, British Columbia",Canada,256,9,20,29,102
"Peloffy, Andre",F,02/25/1951,Sete,France,9,0,0,0,0
"Peltier, Derek",D,03/14/1985,"Plymouth, Minnesota",United States,14,0,0,0,2
"Peltonen, Ville",F,05/24/1973,Vantaa,Finland,382,52,96,148,119
"Peluso, Anthony",F,04/18/1989,"North York, Ontario",Canada,148,4,10,14,220
"Peluso, Mike",F,11/08/1965,"Pengilly, Minnesota",United States,458,38,52,90,1951
"Peluso, Mike",F,09/02/1974,"Bismarck, North Dakota",United States,38,4,2,6,19
"Pelyk, Mike",D,09/29/1947,"Toronto, Ontario",Canada,441,26,88,114,566
"Penner, Dustin",F,09/28/1982,"Winkler, Manitoba",Canada,589,151,159,310,354
"Penner, Jeffrey",D,04/13/1987,"Steinbach, Manitoba",Canada,2,0,0,0,0
"Penney, Chad",F,09/18/1973,"Labrador City, Newfoundland and Labrador",Canada,3,0,0,0,2
"Penney, Steve",G,02/02/1961,"Québec City, Quebec",Canada,91,0,1,1,15
"Pennington, Cliff",F,04/18/1940,"Winnipeg, Manitoba",Canada,102,17,42,59,6
"Peplinski, Jim",F,10/24/1960,"Renfrew, Ontario",Canada,711,161,263,424,1467
"Percy, Stuart",D,05/18/1993,"Oakville, Ontario",Canada,12,0,3,3,2
"Perezhogin, Alexander",F,08/10/1983,Ust-Kamenogorsk,Kazakhstan,128,15,19,34,86
"Perfetti, Cole",F,01/01/2002,"Whitby, Ontario",Canada,18,2,5,7,0
"Perlini, Brendan",F,04/27/1996,"Guildford, England",United Kingdom,262,50,31,81,92
"Perlini, Fred",F,04/12/1962,"Sault Ste. Marie, Ontario",Canada,8,2,3,5,0
"Perrault, Joel",F,04/06/1983,"Montréal, Quebec",Canada,96,12,14,26,68
"Perreault, Bob",G,01/28/1931,"Trois-Rivières, Quebec",Canada,31,0,0,0,0
"Perreault, Fern",F,03/31/1927,"Chambly, Quebec",Canada,3,0,0,0,0
"Perreault, Gilbert",F,11/13/1950,"Victoriaville, Quebec",Canada,1191,512,814,1326,500
"Perreault, Jacob",F,04/15/2002,"Hinsdale, Illinois",United States,1,0,0,0,0
"Perreault, Mathieu",F,01/05/1988,"Drummondville, Quebec",Canada,708,143,209,352,322
"Perreault, Yanic",F,04/04/1971,"Sherbrooke, Quebec",Canada,859,247,269,516,402
"Perrin, Eric",F,11/01/1975,"Laval, Quebec",Canada,245,32,72,104,92
"Perron, David",F,05/28/1988,"Sherbrooke, Quebec",Canada,973,269,396,665,718
"Perrott, Nathan",F,12/08/1976,"Owen Sound, Ontario",Canada,89,4,5,9,251
"Perry, Brian",F,04/06/1944,"Aldershot, England",United Kingdom,96,16,29,45,24
"Perry, Corey",F,05/16/1985,"Peterborough, Ontario",Canada,1176,405,453,858,1285
"Persson, Joel",D,03/04/1994,Kristianstad,Sweden,13,0,2,2,2
"Persson, John",F,05/18/1992,Mora,Sweden,10,1,0,1,6
"Persson, Ricard",D,08/24/1969,Östersund,Sweden,229,10,44,54,262
"Persson, Stefan",D,12/22/1954,Umeå,Sweden,622,52,317,369,574
"Perunovich, Scott",D,08/18/1998,"Hibbing, Minnesota",United States,19,0,6,6,8
"Pesce, Brett",D,11/15/1994,"Tarrytown, New York",United States,475,31,124,155,164
"Pesonen, Harri",F,08/06/1988,Muurame,Finland,4,0,0,0,2
"Pesonen, Janne",F,05/11/1982,Suomussalmi,Finland,7,0,0,0,0
"Pesut, George",D,06/17/1953,"Saskatoon, Saskatchewan",Canada,92,3,22,25,130
"Petan, Nic",F,03/22/1995,"Vancouver, British Columbia",Canada,154,6,24,30,42
"Peterka, John",F,01/14/2002,Munich,Germany,2,0,0,0,0
"Peters, Andrew",F,05/05/1980,"St. Catharines, Ontario",Canada,229,4,3,7,650
"Peters, Frank",D,06/05/1905,"Rouses Point, New York",United States,43,0,0,0,57
"Peters, Garry",F,10/09/1942,"Regina, Saskatchewan",Canada,311,34,34,68,261
"Peters, Jim",F,10/02/1922,"Montréal, Quebec",Canada,574,125,150,275,184
"Peters, Jim",F,06/20/1944,"Montréal, Quebec",Canada,309,37,36,73,46
"Peters, Justin",G,08/30/1986,"Blyth, Ontario",Canada,83,0,2,2,8
"Peters, Steve",F,01/23/1960,"Peterborough, Ontario",Canada,2,0,1,1,0
"Peters, Warren",F,07/10/1982,"Saskatoon, Saskatchewan",Canada,96,4,4,8,72
"Petersen, Cal",G,10/19/1994,"Waterloo, Iowa",United States,91,0,1,1,2
"Petersen, Toby",F,10/27/1978,"Minneapolis, Minnesota",United States,398,33,48,81,50
"Peterson, Brent",F,07/20/1972,"Calgary, Alberta",Canada,56,9,1,10,6
"Peterson, Brent",F,02/15/1958,"Calgary, Alberta",Canada,620,72,141,213,484
"Peterson, Jacob",F,07/19/1999,Lidköping,Sweden,65,12,5,17,12
"Petersson, André",F,09/11/1990,Olofström,Sweden,1,0,0,0,0
"Petiot, Richard",D,08/20/1982,"Daysland, Alberta",Canada,15,0,3,3,25
"Petit, Michel",D,02/12/1964,"Saint-Malo, Quebec",Canada,827,90,238,328,1839
"Petrecki, Nick",D,07/11/1989,"Schenectady, New York",United States,1,0,0,0,0
"Petrell, Lennart",F,04/13/1984,Helsinki,Finland,95,7,11,18,49
"Petrenko, Sergei",F,09/10/1968,Kharkiv,Ukraine,14,0,4,4,0
"Petrov, Oleg",F,04/18/1971,Moscow,Russia,382,72,115,187,101
"Petrovic, Alex",D,03/03/1992,"Edmonton, Alberta",Canada,263,5,45,50,360
"Petrovicky, Robert",F,10/26/1973,Kosice,Slovakia,208,27,38,65,118
"Petrovicky, Ronald",F,02/15/1977,Žilina,Slovakia,342,41,51,92,429
"Petruzalek, Jakub",F,04/24/1985,Litvinov,Czech Republic,2,0,1,1,0
"Petry, Jeff",D,12/09/1987,"Ann Arbor, Michigan",United States,803,87,235,322,325
"Pettersson, Elias",F,11/12/1998,Sundsvall,Sweden,245,97,124,221,48
"Pettersson, Jörgen",F,07/11/1956,Göteborg,Sweden,435,174,192,366,117
"Pettersson, Marcus",D,05/08/1996,Skellefteå,Sweden,294,9,70,79,167
"Pettie, Jim",G,10/24/1953,"Toronto, Ontario",Canada,21,0,0,0,23
"Pettinen, Tomi",D,06/17/1977,Ylöjärvi,Finland,24,0,0,0,18
"Pettinger, Eric",F,12/14/1904,"North Bierley, England",United Kingdom,98,7,12,19,85
"Pettinger, Gordon",F,11/11/1911,"Harrogate, England",United Kingdom,292,42,72,114,77
"Pettinger, Matt",F,10/22/1980,"Edmonton, Alberta",Canada,422,65,58,123,210
"Peverley, Rich",F,07/08/1982,"Guelph, Ontario",Canada,442,84,157,241,167
"Pezzetta, Michael",F,03/13/1998,"Toronto, Ontario",Canada,51,5,6,11,81
"Phair, Lyle",F,08/31/1961,"Pilot Mound, Manitoba",Canada,48,6,7,13,12
"Phaneuf, Dion",D,04/10/1985,"Edmonton, Alberta",Canada,1048,137,357,494,1345
"Phillipoff, Harold",F,07/14/1956,"Kamsack, Saskatchewan",Canada,141,26,57,83,267
"Phillips, Bill",F,09/23/1902,"Carleton Place, Ontario",Canada,27,1,1,2,6
"Phillips, Charlie",D,05/10/1917,"Toronto, Ontario",Canada,17,0,0,0,6
"Phillips, Chris",D,03/09/1978,"Fort McMurray, Alberta",Canada,1179,71,217,288,756
"Phillips, Isaak",D,09/28/2001,"Barrie, Ontario",Canada,4,0,0,0,4
"Phillips, Matthew",F,04/06/1998,"Calgary, Alberta",Canada,1,0,0,0,0
"Phillips, Merlyn",F,05/24/1899,"Richmond Hill, Ontario",Canada,302,52,31,83,228
"Picard, Alexandre",D,07/05/1985,"Gatineau, Quebec",Canada,253,19,50,69,86
"Picard, Alexandre",F,10/09/1985,"Les Saules, Quebec",Canada,67,0,2,2,58
"Picard, Michel",F,11/07/1969,"Beauport, Quebec",Canada,166,28,42,70,103
"Picard, Noel",D,12/25/1938,"Montréal, Quebec",Canada,336,12,63,75,614
"Picard, Robert",D,05/25/1957,"Montréal, Quebec",Canada,899,104,319,423,1025
"Picard, Roger",F,01/13/1935,"Montréal, Quebec",Canada,15,2,2,4,21
"Pichette, Dave",D,02/04/1960,"Grand Falls, Newfoundland and Labrador",Canada,322,41,140,181,344
"Pickard, Calvin",G,04/15/1992,"Winnipeg, Manitoba",Canada,116,0,3,3,4
"Picketts, Hal",F,04/22/1909,"Asquith, Saskatchewan",Canada,48,3,1,4,32
"Pidhirny, Harry",F,03/05/1928,"Toronto, Ontario",Canada,2,0,0,0,0
"Pielmeier, Timo",G,07/07/1989,Deggendorf,Germany,1,0,0,0,0
"Pierce, Randy",F,11/23/1957,"Arnprior, Ontario",Canada,277,62,76,138,223
"Pietila, Blake",F,02/20/1993,"Brighton, Michigan",United States,38,1,3,4,12
"Pietrangelo, Alex",D,01/18/1990,"King City, Ontario",Canada,879,129,388,517,299
"Pietrangelo, Frank",G,12/17/1964,"Niagara Falls, Ontario",Canada,141,0,3,3,36
"Pihlman, Tuomas",F,11/13/1982,Espoo,Finland,15,1,1,2,12
"Pihlström, Antti",F,10/22/1984,Vantaa,Finland,54,2,5,7,10
"Pike, Alf",F,09/15/1917,"Winnipeg, Manitoba",Canada,234,42,77,119,145
"Pikkarainen, Ilkka",F,04/19/1981,Sonkajärvi,Finland,31,1,3,4,10
"Pilar, Karel",D,12/23/1977,Prague,Czech Republic,90,6,24,30,42
"Pilon, Garrett",F,04/13/1998,"Mineola, New York",United States,3,1,0,1,0
"Pilon, Richard",D,04/30/1968,"Saskatoon, Saskatchewan",Canada,631,8,69,77,1745
"Pilote, Pierre",D,12/11/1931,"Kenogami, Quebec",Canada,890,80,418,498,1257
"Pilut, Lawrence",D,12/30/1995,Tingsryd,Sweden,46,1,5,6,24
"Pinder, Gerry",F,09/15/1948,"Saskatoon, Saskatchewan",Canada,223,55,69,124,135
"Pineault, Adam",F,05/23/1986,"Holyoke, Massachusetts",United States,3,0,0,0,0
"Pinho, Brian",F,05/01/1995,"North Andover, Massachusetts",United States,2,0,0,0,0
"Pinizzotto, Steven",F,04/26/1984,"Mississauga, Ontario",Canada,36,2,4,6,74
"Pinto, Shane",F,11/12/2000,"Franklin Square, New York",United States,17,1,7,8,12
"Pionk, Neal",D,07/29/1995,"Omaha, Nebraska",United States,303,19,132,151,145
"Pirjetä, Lasse",F,04/04/1974,Haukipudas,Finland,146,23,27,50,50
"Pirnes, Esa",F,04/01/1977,Oulu,Finland,57,3,8,11,12
"Piros, Kamil",F,11/20/1978,Most,Czech Republic,28,4,4,8,10
"Pirri, Brandon",F,04/10/1991,"Toronto, Ontario",Canada,276,72,49,121,91
"Pirus, Alex",F,01/12/1955,"Toronto, Ontario",Canada,159,30,28,58,94
"Pisa, Ales",D,01/02/1977,Pardubice,Czech Republic,53,1,3,4,26
"Pisani, Fernando",F,12/27/1976,"Edmonton, Alberta",Canada,462,87,82,169,200
"Piskula, Joe",D,07/05/1984,"Antigo, Wisconsin",United States,13,0,0,0,10
"Pitkänen, Joni",D,09/19/1983,Oulu,Finland,535,57,225,282,484
"Pitlick, Lance",D,11/05/1967,"Minneapolis, Minnesota",United States,393,16,33,49,298
"Pitlick, Rem",F,04/02/1997,"Plymouth, Minnesota",United States,77,15,24,39,30
"Pitlick, Tyler",F,11/01/1991,"Minneapolis, Minnesota",United States,325,48,41,89,84
"Pitre, Didier",F,09/01/1883,"Salaberry-de-Valleyfield, Quebec",Canada,127,64,35,99,87
"Pittis, Domenic",F,10/01/1974,"Calgary, Alberta",Canada,86,5,11,16,71
"Pivko, Libor",F,03/29/1980,Novy Jicin,Czech Republic,1,0,0,0,0
"Pivonka, Michal",F,01/28/1966,Kladno,Czech Republic,825,181,418,599,476
"Plager, Barclay",D,03/26/1941,"Kirkland Lake, Ontario",Canada,614,44,187,231,1115
"Plager, Bill",D,07/06/1945,"Kirkland Lake, Ontario",Canada,263,4,34,38,294
"Plager, Bob",D,03/11/1943,"Kirkland Lake, Ontario",Canada,645,20,126,146,800
"Plamondon, Gerry",F,01/05/1925,"Sherbrooke, Quebec",Canada,74,7,13,20,10
"Plante, Alex",D,05/09/1989,"Brandon, Manitoba",Canada,10,0,2,2,15
"Plante, Cam",D,03/12/1964,"Brandon, Manitoba",Canada,2,0,0,0,0
"Plante, Dan",F,10/05/1971,"Hayward, Wisconsin",United States,159,9,14,23,135
"Plante, Derek",F,01/17/1971,"Cloquet, Minnesota",United States,450,96,152,248,138
"Plante, Jacques",G,01/17/1929,"Shawinigan, Quebec",Canada,837,0,8,8,92
"Plante, Pierre",F,05/14/1951,"Salaberry-de-Valleyfield, Quebec",Canada,599,125,172,297,599
"Plantery, Mark",D,08/14/1959,"St. Catharines, Ontario",Canada,25,1,5,6,14
"Plasse, Michel",G,06/01/1948,"Montréal, Quebec",Canada,298,0,9,9,52
"Platt, Geoff",F,07/10/1985,"Toronto, Ontario",Canada,46,4,10,14,28
"Plavsic, Adrien",D,01/13/1970,"Montréal, Quebec",Canada,214,16,56,72,161
"Plaxton, Hugh",F,05/16/1904,"Barrie, Ontario",Canada,17,1,3,4,4
"Playfair, Jim",D,05/22/1964,"Fort St. James, British Columbia",Canada,21,2,4,6,51
"Playfair, Larry",D,06/23/1958,"Fort St. James, British Columbia",Canada,688,26,94,120,1814
"Pleau, Larry",F,01/29/1947,"Lynn, Massachusetts",United States,94,9,15,24,22
"Plekanec, Tomas",F,10/31/1982,Kladno,Czech Republic,1001,233,375,608,543
"Pletka, Václav",F,06/08/1979,Mlada Boleslav,Czech Republic,1,0,0,0,0
"Plett, Willi",F,06/07/1955,Asuncion,Paraguay,834,222,215,437,2570
"Plihal, Tomas",F,03/28/1983,Frydlant v Cechach,Czech Republic,89,7,9,16,26
"Plotnikov, Sergei",F,06/03/1990,Komsomolsk-on-Amur,Russia,45,0,3,3,24
"Plumb, Rob",F,08/29/1957,"Kingston, Ontario",Canada,14,3,2,5,2
"Plumb, Ron",D,07/17/1950,"Kingston, Ontario",Canada,26,3,4,7,14
"Poapst, Steve",D,01/03/1969,"Cornwall, Ontario",Canada,307,8,28,36,173
"Pöck, Thomas",D,12/02/1981,Klagenfurt,Austria,118,8,9,17,55
"Pocza, Harvie",F,09/22/1959,"Lethbridge, Alberta",Canada,3,0,0,0,2
"Poddubny, Walt",F,02/14/1960,"Thunder Bay, Ontario",Canada,468,184,238,422,454
"Podein, Shjon",F,03/05/1968,"Rochester, Minnesota",United States,699,100,106,206,439
"Podkolzin, Vasili",F,06/24/2001,Moscow,Russia,79,14,12,26,26
"Podkonický, Andrej",F,05/09/1978,Zvolen,Slovakia,8,1,0,1,2
"Podloski, Ray",F,01/05/1966,"Edmonton, Alberta",Canada,8,0,1,1,17
"Podollan, Jason",F,02/18/1976,"Vernon, British Columbia",Canada,41,1,5,6,19
"Podolsky, Nels",F,12/19/1925,"Winnipeg, Manitoba",Canada,1,0,0,0,0
"Poehling, Ryan",F,01/03/1999,"Lakeville, Minnesota",United States,85,13,9,22,10
"Poeschek, Rudy",D,09/29/1966,"Kamloops, British Columbia",Canada,364,6,25,31,817
"Poeta, Tony",F,03/04/1933,"North Bay, Ontario",Canada,1,0,0,0,0
"Poganski, Austin",F,02/16/1996,"St. Cloud, Minnesota",United States,22,0,0,0,7
"Pogge, Justin",G,04/22/1986,"Fort McMurray, Alberta",Canada,7,0,0,0,0
"Pohl, John",F,06/29/1979,"Rochester, Minnesota",United States,115,17,21,38,24
"Poile, Bud",F,02/10/1924,"Thunder Bay, Ontario",Canada,311,107,122,229,91
"Poile, Don",F,06/01/1932,"Thunder Bay, Ontario",Canada,67,7,9,16,12
"Point, Brayden",F,03/13/1996,"Calgary, Alberta",Canada,417,167,201,368,121
"Poirier, Emile",F,12/14/1994,"Montréal, Quebec",Canada,8,0,1,1,2
"Poirier, Gordon",F,10/27/1914,"Maple Creek, Saskatchewan",Canada,10,0,1,1,0
"Polák, Roman",D,04/28/1986,Ostrava,Czech Republic,806,26,114,140,643
"Polák, Vojtech",F,06/27/1985,Ostrov nad Ohri,Czech Republic,5,0,0,0,0
"Polanic, Tom",D,04/02/1943,"Toronto, Ontario",Canada,19,0,2,2,53
"Polich, John",F,07/08/1916,"Hibbing, Minnesota",United States,3,0,1,1,0
"Polich, Mike",F,12/19/1952,"Hibbing, Minnesota",United States,226,24,29,53,57
"Polis, Greg",F,08/08/1950,"Westlock, Alberta",Canada,615,174,169,343,391
"Poliziani, Daniel",F,01/08/1935,"Sydney, Nova Scotia",Canada,1,0,0,0,0
"Pollock, Jame",D,06/16/1979,"Québec City, Quebec",Canada,9,0,0,0,6
"Polonich, Dennis",F,12/04/1953,"Foam Lake, Saskatchewan",Canada,390,59,82,141,1242
"Pominville, Jason",F,11/30/1982,"Repentigny, Quebec",Canada,1060,293,434,727,199
"Ponikarovsky, Alexei",F,04/09/1980,Kiev,Ukraine,678,139,184,323,419
"Pooley, Paul",F,08/02/1960,"Exeter, Ontario",Canada,15,0,3,3,0
"Poolman, Tucker",D,06/08/1993,"East Grand Forks, Minnesota",United States,160,6,16,22,38
"Popein, Larry",F,08/11/1930,"Yorkton, Saskatchewan",Canada,449,80,141,221,162
"Popiel, Poul",D,02/28/1943,Sollested,Denmark,225,13,41,54,212
"Popovic, Mark",D,10/11/1982,"Stoney Creek, Ontario",Canada,81,2,5,7,20
"Popovic, Peter",D,02/10/1968,Köping,Sweden,485,10,63,73,291
"Pöpperle, Tomas",G,10/10/1984,Broumov,Czech Republic,2,0,0,0,0
"Porter, Chris",F,05/29/1984,"Toronto, Ontario",Canada,234,15,19,34,39
"Porter, Kevin",F,03/12/1986,"Detroit, Michigan",United States,249,29,29,58,60
"Portland, Jack",D,07/30/1912,"Waubaushene, Ontario",Canada,388,15,56,71,325
"Porvari, Jukka",F,01/19/1954,Tampere,Finland,39,3,9,12,4
"Posa, Victor",F,11/05/1966,Bari,Italy,2,0,0,0,2
"Posavad, Mike",D,01/03/1964,"Brantford, Ontario",Canada,8,0,0,0,0
"Posmyk, Marek",D,09/15/1978,Jihlava,Czech Republic,19,1,2,3,20
"Postma, Paul",D,02/22/1989,"Red Deer, Alberta",Canada,205,10,25,35,51
"Pothier, Brian",D,04/15/1977,"New Bedford, Massachusetts",United States,362,26,92,118,202
"Poti, Tom",D,03/22/1977,"Worcester, Massachusetts",United States,824,69,258,327,586
"Potomski, Barry",F,11/24/1972,"Windsor, Ontario",Canada,68,6,5,11,227
"Potter, Corey",D,01/05/1984,"Lansing, Michigan",United States,130,8,24,32,53
"Potulny, Ryan",F,09/05/1984,"Grand Forks, North Dakota",United States,126,22,27,49,54
"Poturalski, Andrew",F,01/14/1994,"Williamsville, New York",United States,4,0,2,2,0
"Potvin, Denis",D,10/29/1953,"Ottawa, Ontario",Canada,1060,310,742,1052,1356
"Potvin, Felix",G,06/23/1971,"Anjou, Quebec",Canada,635,0,16,16,82
"Potvin, Jean",D,03/25/1949,"Ottawa, Ontario",Canada,613,63,224,287,478
"Potvin, Marc",F,01/29/1967,"Ottawa, Ontario",Canada,121,3,5,8,456
"Poudrier, Dan",D,02/15/1964,"Thetford Mines, Quebec",Canada,25,1,5,6,10
"Poulin, Dan",D,09/19/1957,"Robertsonville, Quebec",Canada,3,1,1,2,2
"Poulin, Dave",F,12/17/1958,"Timmins, Ontario",Canada,724,205,325,530,482
"Poulin, Kevin",G,04/12/1990,"Montréal, Quebec",Canada,50,0,1,1,0
"Poulin, Patrick",F,04/23/1973,"Vanier, Quebec",Canada,634,101,134,235,299
"Pouliot, Benoit",F,09/29/1986,"Alfred, Ontario",Canada,625,130,133,263,371
"Pouliot, Derrick",D,01/16/1994,"Weyburn, Saskatchewan",Canada,213,8,44,52,85
"Pouliot, Marc-Antoine",F,05/22/1985,"Québec City, Quebec",Canada,192,21,36,57,76
"Pouzar, Jaroslav",F,01/23/1952,Cakovec,Czech Republic,186,34,48,82,137
"Powe, Darroll",F,06/22/1985,"Saskatoon, Saskatchewan",Canada,329,28,28,56,214
"Powell, Ray",F,11/16/1925,"Timmins, Ontario",Canada,31,7,15,22,2
"Power, Owen",D,11/22/2002,"Mississauga, Ontario",Canada,8,2,1,3,2
"Powis, Geoff",F,06/14/1945,"Winnipeg, Manitoba",Canada,2,0,0,0,0
"Powis, Lynn",F,07/07/1949,"Maryfield, Saskatchewan",Canada,130,19,33,52,25
"Prajsler, Petr",D,09/21/1965,Hradec Kralove,Czech Republic,46,3,10,13,51
"Pratt, Jack",D,04/13/1906,"Edinburgh, Scotland",United Kingdom,37,2,0,2,42
"Pratt, Kelly",F,02/08/1953,"High Prairie, Alberta",Canada,22,0,6,6,15
"Pratt, Nolan",D,08/14/1975,"Fort McMurray, Alberta",Canada,592,9,56,65,537
"Pratt, Tracy",D,03/08/1943,"New York, New York",United States,580,17,97,114,1026
"Pratt, Walter 'Babe'",D,01/07/1916,"Stony Mountain, Manitoba",Canada,518,83,210,293,491
"Preissing, Tom",D,12/03/1978,"Arlington Heights, Illinois",United States,326,31,101,132,78
"Prentice, Dean",F,10/05/1932,"Timmins, Ontario",Canada,1378,391,469,860,487
"Prentice, Eric",D,08/22/1926,"Timmins, Ontario",Canada,5,0,0,0,4
"Presley, Wayne",F,03/23/1965,"Dearborn, Michigan",United States,684,155,147,302,953
"Preston, Rich",F,05/22/1952,"Regina, Saskatchewan",Canada,580,127,164,291,348
"Preston, Yves",F,06/14/1956,"Montréal, Quebec",Canada,28,7,3,10,4
"Price, Carey",G,08/16/1987,"Vancouver, British Columbia",Canada,712,0,13,13,51
"Price, Jack",D,05/08/1932,"Goderich, Ontario",Canada,57,4,6,10,24
"Price, Noel",D,12/09/1935,"Brockville, Ontario",Canada,500,14,114,128,333
"Price, Pat",D,03/24/1955,"Nelson, British Columbia",Canada,726,43,218,261,1456
"Price, Tom",D,07/12/1954,"Toronto, Ontario",Canada,29,0,2,2,12
"Priestlay, Ken",F,08/24/1967,"Richmond, British Columbia",Canada,168,27,34,61,63
"Primeau, Cayden",G,08/11/1999,"Voorhees Township, New Jersey",United States,18,0,0,0,0
"Primeau, Joe",F,01/29/1906,"Lindsay, Ontario",Canada,310,66,177,243,105
"Primeau, Keith",F,11/24/1971,"Toronto, Ontario",Canada,909,266,353,619,1541
"Primeau, Kevin",F,01/03/1956,"Edmonton, Alberta",Canada,2,0,0,0,4
"Primeau, Wayne",F,06/04/1976,"Scarborough, Ontario",Canada,774,69,125,194,789
"Prince, Shane",F,11/16/1992,"Rochester, New York",United States,128,12,26,38,39
"Pringle, Ellie",D,08/31/1911,"Toronto, Ontario",Canada,6,0,0,0,0
"Printz, David",D,07/24/1980,Stockholm,Sweden,13,0,0,0,4
"Priskie, Chase",D,03/19/1996,"Pembroke Pines, Florida",United States,4,0,0,0,2
"Probert, Bob",F,06/05/1965,"Windsor, Ontario",Canada,935,163,221,384,3300
"Procházka, Martin",F,03/03/1972,Slany,Czech Republic,32,2,5,7,8
"Prodgers, George",F,10/18/1891,"London, Ontario",Canada,111,63,33,96,39
"Prokhorkin, Nikolai",F,09/17/1993,Chelyabinsk,Russia,43,4,10,14,6
"Prokhorov, Vitali",F,12/25/1966,Moscow,Russia,83,19,11,30,35
"Prokopec, Mike",F,05/17/1974,"Toronto, Ontario",Canada,15,0,0,0,11
"Pronger, Chris",D,10/10/1974,"Dryden, Ontario",Canada,1167,157,541,698,1590
"Pronger, Sean",F,11/30/1972,"Thunder Bay, Ontario",Canada,260,23,36,59,159
"Pronovost, Andre",F,07/09/1936,"Shawinigan, Quebec",Canada,557,94,104,198,405
"Pronovost, Claude",G,07/22/1935,"Shawinigan, Quebec",Canada,3,0,0,0,2
"Pronovost, Jean",F,12/18/1945,"Shawinigan, Quebec",Canada,998,391,383,774,413
"Pronovost, Marcel",D,06/15/1930,"Lac-a-la-Tortue, Quebec",Canada,1206,88,257,345,847
"Propp, Brian",F,02/15/1959,"Lanigan, Saskatchewan",Canada,1016,425,579,1004,825
"Prospal, Václav",F,02/17/1975,Ceske Budejovice,Czech Republic,1108,255,510,765,581
"Prosser, Nate",D,05/07/1986,"Elk River, Minnesota",United States,360,11,38,49,231
"Prosvetov, Ivan",G,03/05/1999,Moscow,Russia,6,0,0,0,0
"Protas, Alexei",F,01/06/2001,Vitebsk,Belarus,33,3,6,9,0
"Proulx, Christian",D,12/10/1973,"Coaticook, Quebec",Canada,7,1,2,3,20
"Prout, Dalton",D,03/13/1990,"LaSalle, Ontario",Canada,264,7,31,38,321
"Provorov, Ivan",D,01/13/1997,Yaroslavl,Russia,450,59,131,190,172
"Provost, Claude",F,09/17/1933,"Montréal, Quebec",Canada,1005,254,335,589,475
"Prow, Ethan",D,11/17/1992,"Sauk Rapids, Minnesota",United States,4,1,0,1,0
"Prpic, Joel",F,09/25/1974,"Sudbury, Ontario",Canada,18,0,3,3,4
"Prucha, Petr",F,09/14/1982,Chrudim,Czech Republic,346,78,68,146,133
"Prusek, Martin",G,12/11/1975,Ostrava,Czech Republic,57,0,1,1,0
"Prust, Brandon",F,03/16/1984,"London, Ontario",Canada,486,40,75,115,1036
"Pryakhin, Sergei",F,12/07/1963,Moscow,Russia,46,3,8,11,2
"Pryor, Chris",D,01/23/1961,"St. Paul, Minnesota",United States,82,1,4,5,122
"Prystai, Metro",F,11/07/1927,"Yorkton, Saskatchewan",Canada,675,151,179,330,229
"Pudas, Albert",F,02/17/1899,Siikajoki,Finland,4,0,0,0,0
"Puempel, Matt",F,01/24/1993,"Essex, Ontario",Canada,87,11,5,16,30
"Pulford, Bob",F,03/31/1936,"Newton Robinson, Ontario",Canada,1079,281,362,643,793
"Puljujärvi, Jesse",F,05/07/1998,Älvkarleby,Sweden,259,46,52,98,76
"Pulkkinen, Dave",D,05/18/1949,"Kapuskasing, Ontario",Canada,2,0,0,0,0
"Pulkkinen, Teemu",F,01/02/1992,Vantaa,Finland,83,13,9,22,32
"Pulock, Ryan",D,10/06/1994,"Dauphin, Manitoba",Canada,346,38,108,146,65
"Puppa, Daren",G,03/23/1965,"Kirkland Lake, Ontario",Canada,429,0,18,18,48
"Purcell, Teddy",F,09/08/1985,"St. John's, Newfoundland and Labrador",Canada,571,101,206,307,102
"Purinton, Dale",D,10/11/1976,"Fort Wayne, Indiana",United States,181,4,16,20,578
"Purpur, Cliff 'Fido'",F,09/26/1914,"Grand Forks, North Dakota",United States,144,25,35,60,46
"Purves, John",F,02/12/1968,"Toronto, Ontario",Canada,7,1,0,1,0
"Pusey, Chris",G,06/30/1965,"Brantford, Ontario",Canada,1,0,0,0,0
"Pushkarev, Konstantin",F,02/12/1985,Ust-Kamenogorsk,Kazakhstan,17,2,3,5,8
"Pushor, Jamie",D,02/11/1973,"Lethbridge, Alberta",Canada,521,14,46,60,648
"Pusie, Jean",D,10/15/1910,"Montréal, Quebec",Canada,65,1,4,5,28
"Puustinen, Valtteri",F,06/04/1999,Kuopio,Finland,1,0,1,1,0
"Pyatt, Nelson",F,09/09/1953,"Thunder Bay, Ontario",Canada,296,71,63,134,69
"Pyatt, Taylor",F,08/19/1981,"Thunder Bay, Ontario",Canada,859,140,140,280,430
"Pyatt, Tom",F,02/14/1987,"Thunder Bay, Ontario",Canada,445,43,58,101,71
"Pyörälä, Mika",F,07/13/1981,Oulu,Finland,36,2,2,4,10
"Pysyk, Mark",D,01/11/1992,"Sherwood Park, Alberta",Canada,521,28,76,104,162
"Quackenbush, Bill",D,03/02/1922,"Toronto, Ontario",Canada,775,62,223,285,95
"Quackenbush, Max",D,08/29/1928,"Toronto, Ontario",Canada,61,4,7,11,30
"Quenneville, Joel",D,09/15/1958,"Windsor, Ontario",Canada,803,54,136,190,705
"Quenneville, John",F,04/16/1996,"Edmonton, Alberta",Canada,42,2,3,5,6
"Quenneville, Leo",F,06/15/1900,"Saint-Anicet, Quebec",Canada,25,0,3,3,10
"Quick, Jonathan",G,01/21/1986,"Milford, Connecticut",United States,712,0,20,20,64
"Quick, Kevin",D,03/29/1988,"Buffalo, New York",United States,6,0,1,1,0
"Quilty, John",F,01/21/1921,"Ottawa, Ontario",Canada,125,36,34,70,81
"Quincey, Kyle",D,08/12/1985,"Kitchener, Ontario",Canada,586,36,122,158,548
"Quine, Alan",F,02/25/1993,"Belleville, Ontario",Canada,106,10,18,28,22
"Quinn, Dan",F,06/01/1965,"Ottawa, Ontario",Canada,805,266,419,685,531
"Quinn, Jack",F,09/19/2001,"Cobden, Ontario",Canada,2,1,1,2,0
"Quinn, Pat",D,01/29/1943,"Hamilton, Ontario",Canada,606,18,113,131,952
"Quinney, Gage",F,07/29/1995,"Las Vegas, Nevada",United States,3,0,1,1,0
"Quinney, Ken",F,05/23/1965,"New Westminster, British Columbia",Canada,59,7,13,20,23
"Quint, Deron",D,03/12/1976,"Durham, New Hampshire",United States,463,46,97,143,166
"Quintal, Stephane",D,10/22/1968,"Boucherville, Quebec",Canada,1037,63,180,243,1320
"Quintin, Jean Francois",F,05/28/1969,"Saint-Jean-sur-Richelieu, Quebec",Canada,22,5,5,10,4
"Raanta, Antti",G,05/12/1989,Rauma,Finland,226,0,3,3,2
"Rachunek, Karel",D,08/27/1979,Zlin,Czech Republic,371,22,118,140,227
"Racicot, Andre",G,06/09/1969,"Rouyn-Noranda, Quebec",Canada,68,0,2,2,6
"Racine, Bruce",G,08/09/1966,"Cornwall, Ontario",Canada,11,0,0,0,2
"Racine, Jonathan",D,05/28/1993,"Montréal, Quebec",Canada,1,0,0,0,2
"Racine, Yves",D,02/07/1969,"Matane, Quebec",Canada,508,37,194,231,439
"Raddysh, Darren",D,02/28/1996,"Caledon, Ontario",Canada,4,0,0,0,0
"Raddysh, Taylor",F,02/18/1998,"Toronto, Ontario",Canada,74,11,11,22,10
"Radil, Lukas",F,08/05/1990,Caslav,Czech Republic,50,7,4,11,14
"Radivojevic, Branko",F,11/24/1980,Piestany,Slovakia,393,52,68,120,252
"Radley, Yip",D,06/27/1908,"Ottawa, Ontario",Canada,18,0,1,1,13
"Radulov, Alexander",F,07/05/1986,Nizhny Tagil,Russia,524,144,224,368,344
"Radulov, Igor",F,08/23/1982,Nizhny Tagil,Russia,43,9,7,16,22
"Raduns, Nate",F,05/17/1984,"Sauk Rapids, Minnesota",United States,1,0,0,0,0
"Rafalski, Brian",D,09/28/1973,"Dearborn, Michigan",United States,833,79,436,515,282
"Rafferty, Brogan",D,05/28/1995,"West Dundee, Illinois",United States,3,0,1,1,0
"Raffl, Michael",F,12/01/1988,Villach,Austria,590,89,90,179,235
"Raglan, Clare",D,09/04/1927,"Pembroke, Ontario",Canada,100,4,9,13,52
"Raglan, Herb",F,08/05/1967,"Peterborough, Ontario",Canada,343,33,56,89,775
"Ragnarsson, Marcus",D,08/13/1971,Östervåla,Sweden,632,37,140,177,482
"Rakell, Rickard",F,05/05/1993,Sundbyberg,Sweden,569,158,194,352,120
"Rakhshani, Rhett",F,03/06/1988,"Orange, California",United States,7,0,0,0,2
"Raleigh, Don",F,06/27/1926,"Kenora, Ontario",Canada,535,101,219,320,96
"Rallo, Greg",F,08/26/1981,"Gurnee, Illinois",United States,11,1,0,1,2
"Ralph, Brad",F,10/17/1980,"Ottawa, Ontario",Canada,1,0,0,0,0
"Ram, Jamie",G,01/18/1971,"Scarborough, Ontario",Canada,1,0,0,0,0
"Ramage, John",D,02/07/1991,"Mississauga, Ontario",Canada,2,0,0,0,0
"Ramage, Rob",D,01/11/1959,"Byron, Ontario",Canada,1044,139,425,564,2226
"Ramholt, Tim",D,11/02/1984,Zürich,Switzerland,1,0,0,0,0
"Rämö, Karri",G,07/01/1986,Asikkala,Finland,159,0,4,4,16
"Ramsay, Beattie",D,12/12/1895,"Lumsden, Saskatchewan",Canada,43,0,2,2,10
"Ramsay, Craig",F,03/17/1951,"Weston, Ontario",Canada,1070,252,420,672,201
"Ramsay, Les",F,07/01/1920,"Verdun, Quebec",Canada,11,2,2,4,2
"Ramsey, Mike",D,12/03/1960,"Minneapolis, Minnesota",United States,1070,79,266,345,1012
"Ramsey, Wayne",D,01/31/1957,"Hamiota, Manitoba",Canada,2,0,0,0,0
"Randall, Ken",F,12/14/1888,"Kingston, Ontario",Canada,219,70,51,121,581
"Randell, Tyler",F,06/15/1991,"Scarborough, Ontario",Canada,27,6,0,6,47
"Ranford, Bill",G,12/14/1966,"Brandon, Manitoba",Canada,647,0,24,24,65
"Ranford, Brendan",F,05/03/1992,"Edmonton, Alberta",Canada,1,0,0,0,0
"Ranger, Paul",D,09/12/1984,"Whitby, Ontario",Canada,323,24,82,106,254
"Ranheim, Paul",F,01/25/1966,"St. Louis, Missouri",United States,1013,161,199,360,288
"Ranieri, George",F,01/14/1936,"Toronto, Ontario",Canada,2,0,0,0,0
"Ranta, Sampo",F,05/31/2000,Naantali,Finland,10,0,0,0,2
"Rantanen, Mikko",F,10/29/1996,Nousiainen,Finland,408,165,243,408,216
"Rask, Joonas",F,03/24/1990,Savonlinna,Finland,2,0,1,1,0
"Rask, Tuukka",G,03/10/1987,Savonlinna,Finland,564,0,17,17,26
"Rask, Victor",F,03/01/1993,Leksand,Sweden,506,89,134,223,86
"Raska, Adam",F,09/25/2001,Frydek-Mistek,Czech Republic,5,0,0,0,7
"Rasmussen, Dennis",F,07/03/1990,Västerås,Sweden,139,9,12,21,24
"Rasmussen, Erik",F,03/28/1977,"Minneapolis, Minnesota",United States,545,52,76,128,305
"Rasmussen, Michael",F,04/17/1999,"Vancouver, British Columbia",Canada,182,26,31,57,121
"Ratchuk, Peter",D,09/10/1977,"Buffalo, New York",United States,32,1,1,2,10
"Ratcliffe, Isaac",F,02/15/1999,"London, Ontario",Canada,10,1,3,4,10
"Ratelle, Jean",F,10/03/1940,"Lac-Saint-Jean, Quebec",Canada,1280,491,776,1267,276
"Rathbone, Jack",D,05/20/1999,"Boston, Massachusetts",United States,17,1,2,3,2
"Rathje, Mike",D,05/11/1974,"Mannville, Alberta",Canada,768,30,150,180,491
"Rathwell, Jake",F,08/12/1947,"Temiscaming, Quebec",Canada,1,0,0,0,0
"Rattie, Ty",F,02/05/1993,"Calgary, Alberta",Canada,99,13,17,30,12
"Ratushny, Dan",D,10/29/1970,"Nepean, Ontario",Canada,1,0,1,1,2
"Rau, Chad",F,01/18/1987,"Eden Prairie, Minnesota",United States,9,2,0,2,0
"Rau, Kyle",F,10/24/1992,"Eden Prairie, Minnesota",United States,61,2,5,7,15
"Rausse, Errol",F,05/18/1959,"Quesnel, British Columbia",Canada,31,7,3,10,0
"Rautakallio, Pekka",D,07/25/1953,Pori,Finland,235,33,121,154,122
"Ravlich, Matt",D,07/12/1938,"Sault Ste. Marie, Ontario",Canada,411,12,78,90,364
"Ray, Rob",F,06/08/1968,"Stirling, Ontario",Canada,900,41,50,91,3207
"Raycroft, Andrew",G,05/04/1980,"Belleville, Ontario",Canada,280,0,3,3,14
"Raymond, Alain",G,06/24/1965,"Rimouski, Quebec",Canada,1,0,0,0,0
"Raymond, Armand",D,01/12/1913,"Mechanicsville, New York",United States,22,0,3,3,14
"Raymond, Lucas",F,03/28/2002,Göteborg,Sweden,82,23,34,57,16
"Raymond, Mason",F,09/17/1985,"Calgary, Alberta",Canada,546,115,136,251,156
"Raymond, Paul",F,02/27/1913,"Montréal, Quebec",Canada,65,2,1,3,2
"Rayner, Chuck",G,08/11/1920,"Sutherland, Saskatchewan",Canada,425,0,0,0,26
"Read, Matt",F,06/14/1986,"Ilderton, Ontario",Canada,449,88,100,188,83
"Read, Melvin",F,04/10/1924,"Montréal, Quebec",Canada,6,0,0,0,8
"Ready, Ryan",F,11/07/1978,"Peterborough, Ontario",Canada,7,0,1,1,0
"Reardon, Ken",D,04/01/1921,"Winnipeg, Manitoba",Canada,353,26,96,122,604
"Reardon, Terry",D,04/06/1919,"Winnipeg, Manitoba",Canada,194,47,53,100,83
"Reasoner, Marty",F,02/26/1977,"Honeoye Falls, New York",United States,798,97,169,266,379
"Reaugh, Daryl",G,02/13/1965,"Prince George, British Columbia",Canada,27,0,0,0,4
"Reaume, Marc",D,02/07/1934,"LaSalle, Ontario",Canada,344,8,43,51,271
"Reaves, Ryan",F,01/20/1987,"Winnipeg, Manitoba",Canada,755,54,60,114,980
"Reay, Billy",F,08/21/1918,"Winnipeg, Manitoba",Canada,479,105,162,267,202
"Recchi, Mark",F,02/01/1968,"Kamloops, British Columbia",Canada,1652,577,956,1533,1033
"Rechlicz, Joel",F,06/14/1987,"Brookfield, Wisconsin",United States,26,0,1,1,105
"Redahl, Gord",F,08/28/1935,"Kinistino, Saskatchewan",Canada,18,0,1,1,0
"Redden, Wade",D,06/12/1977,"Lloydminster, Saskatchewan",Canada,1023,109,348,457,665
"Reddick, Pokey",G,10/06/1964,"Halifax, Nova Scotia",Canada,132,0,1,1,20
"Redding, George",D,03/06/1903,"Peterborough, Ontario",Canada,33,3,2,5,10
"Reddox, Liam",F,01/27/1986,"Whitby, Ontario",Canada,100,6,18,24,34
"Redmond, Craig",D,09/22/1965,"Dawson Creek, British Columbia",Canada,191,16,68,84,134
"Redmond, Dick",D,08/14/1949,"Kirkland Lake, Ontario",Canada,771,133,312,445,504
"Redmond, Keith",F,10/25/1972,"Richmond Hill, Ontario",Canada,12,1,0,1,20
"Redmond, Mickey",F,12/27/1947,"Kirkland Lake, Ontario",Canada,538,233,195,428,219
"Redmond, Zach",D,07/26/1988,"Traverse City, Michigan",United States,133,9,29,38,50
"Redquest, Greg",G,07/30/1956,"Toronto, Ontario",Canada,1,0,0,0,0
"Reece, Dave",G,09/13/1948,"Troy, New York",United States,14,0,0,0,0
"Reeds, Mark",F,01/24/1960,"Burlington, Ontario",Canada,365,45,114,159,135
"Reedy, Scott",F,04/04/1999,"Prior Lake, Minnesota",United States,35,7,2,9,10
"Reekie, Joe",D,02/22/1965,"Victoria, British Columbia",Canada,902,25,139,164,1326
"Reese, Dylan",D,08/29/1984,"Pittsburgh, Pennsylvania",United States,78,3,14,17,40
"Reese, Jeff",G,03/24/1966,"Brantford, Ontario",Canada,174,0,8,8,30
"Regan, Bill",D,12/11/1908,"Creighton Mine, Ontario",Canada,66,3,2,5,69
"Regan, Larry",F,08/09/1930,"North Bay, Ontario",Canada,280,41,95,136,71
"Regehr, Richie",D,01/17/1983,Bandung,Indonesia,20,1,3,4,6
"Regehr, Robyn",D,04/19/1980,Recife,Brazil,1089,36,163,199,972
"Regier, Darcy",D,11/27/1956,"Swift Current, Saskatchewan",Canada,26,0,2,2,35
"Regier, Steve",F,08/31/1984,"Edmonton, Alberta",Canada,26,3,1,4,8
"Regin, Peter",F,04/16/1986,Herning,Denmark,243,23,44,67,64
"Regner, Brent",D,05/17/1989,"Westlock, Alberta",Canada,7,0,0,0,4
"Regula, Alec",D,08/06/2000,"West Bloomfield, Michigan",United States,18,1,0,1,12
"Reibel, Earl",F,07/21/1930,"Kitchener, Ontario",Canada,409,84,161,245,73
"Reich, Jeremy",F,02/11/1979,"Craik, Saskatchewan",Canada,99,2,4,6,161
"Reichel, Kristian",F,06/11/1998,Most,Czech Republic,13,1,1,2,7
"Reichel, Lukas",F,05/17/2002,Nürnberg,Germany,11,0,1,1,0
"Reichel, Robert",F,06/25/1971,Litvinov,Czech Republic,830,252,378,630,388
"Reichert, Craig",F,05/11/1974,"Winnipeg, Manitoba",Canada,3,0,0,0,0
"Reid, Brandon",F,03/09/1981,"Kirkland, Quebec",Canada,13,2,4,6,0
"Reid, Darren",F,05/08/1983,"Lac la Biche, Alberta",Canada,21,0,1,1,18
"Reid, Dave",F,01/11/1934,"Toronto, Ontario",Canada,7,0,0,0,0
"Reid, David",F,05/15/1964,"Toronto, Ontario",Canada,961,165,204,369,253
"Reid, Gord",D,02/19/1912,"Mount Albert, Ontario",Canada,1,0,0,0,2
"Reid, Reg",F,02/17/1899,"Seaforth, Ontario",Canada,39,1,0,1,4
"Reid, Tom",D,06/24/1946,"Fort Erie, Ontario",Canada,701,17,113,130,654
"Reierson, David",D,08/30/1964,"Bashaw, Alberta",Canada,2,0,0,0,2
"Reigle, Ed",D,06/19/1924,"Winnipeg, Manitoba",Canada,17,0,2,2,25
"Reilly, Mike",D,07/13/1993,"Chicago, Illinois",United States,329,12,85,97,130
"Reimer, James",G,03/15/1988,"Winnipeg, Manitoba",Canada,433,0,3,3,14
"Reinhardt, Cole",F,02/01/2000,"Irricana, Alberta",Canada,1,0,0,0,2
"Reinhart, Griffin",D,01/24/1994,"West Vancouver, British Columbia",Canada,37,0,2,2,26
"Reinhart, Max",F,02/04/1992,"Vancouver, British Columbia",Canada,23,1,4,5,6
"Reinhart, Paul",D,01/06/1960,"Kitchener, Ontario",Canada,648,133,426,559,277
"Reinhart, Sam",F,11/06/1995,"North Vancouver, British Columbia",Canada,532,167,210,377,103
"Reinikka, Ollie",F,08/02/1901,"Shuswap, British Columbia",Canada,16,0,0,0,0
"Reinke, Mitch",D,02/04/1996,"Stillwater, Minnesota",United States,1,0,0,0,0
"Reinprecht, Steven",F,05/07/1976,"Edmonton, Alberta",Canada,663,140,242,382,186
"Reirden, Todd",D,06/25/1971,"Deerfield, Illinois",United States,183,11,35,46,181
"Reise, Leo",D,06/07/1922,"Stoney Creek, Ontario",Canada,494,28,81,109,397
"Reise, Leo",D,06/01/1892,"Pembroke, Ontario",Canada,223,39,35,74,204
"Reitz, Erik",D,07/29/1982,"Detroit, Michigan",United States,48,1,1,2,69
"Rempal, Sheldon",F,08/07/1995,"Calgary, Alberta",Canada,11,0,0,0,0
"Renaud, Mark",D,02/21/1959,"Windsor, Ontario",Canada,152,6,50,56,86
"Renberg, Mikael",F,05/05/1972,Piteå,Sweden,661,190,274,464,372
"Rendulic, Borna",F,03/25/1992,Zagreb,Croatia,15,1,1,2,6
"Renouf, Dan",D,06/01/1994,"Pickering, Ontario",Canada,23,0,3,3,23
"Repik, Michal",F,12/31/1988,Vlasim,Czech Republic,72,9,11,20,36
"Resch, Glenn",G,07/10/1948,"Moose Jaw, Saskatchewan",Canada,571,0,16,16,70
"Reunanen, Tarmo",D,03/01/1998,Äänekoski,Finland,4,0,1,1,0
"Reynolds, Bobby",F,07/14/1967,"Flint, Michigan",United States,7,1,1,2,0
"Rheault, Jon",F,08/01/1986,"Arlington, Texas",United States,5,0,0,0,0
"Rheaume, Herb",G,01/12/1900,"Mason, Quebec",Canada,31,0,0,0,0
"Rheaume, Pascal",F,06/21/1973,"Québec City, Quebec",Canada,318,39,52,91,144
"Rhodes, Damian",G,05/28/1969,"St. Paul, Minnesota",United States,309,1,6,7,34
"Ribble, Pat",D,04/26/1954,"Leamington, Ontario",Canada,349,19,60,79,365
"Ribeiro, Mike",F,02/10/1980,"Montréal, Quebec",Canada,1074,228,565,793,577
"Ricci, Mike",F,10/27/1971,"Scarborough, Ontario",Canada,1099,243,362,605,974
"Ricci, Nick",G,06/03/1959,"Niagara Falls, Ontario",Canada,19,0,0,0,2
"Rice, Steven",F,05/26/1971,"Kitchener, Ontario",Canada,329,64,61,125,275
"Richard, Anthony",F,12/20/1996,"Trois-Rivières, Quebec",Canada,2,0,0,0,0
"Richard, Henri",F,02/29/1936,"Montréal, Quebec",Canada,1258,358,688,1046,932
"Richard, Jacques",F,10/07/1952,"Québec City, Quebec",Canada,556,160,187,347,307
"Richard, Jean-Marc",D,10/08/1966,"Saint-Raymond, Quebec",Canada,5,2,1,3,2
"Richard, Maurice",F,08/04/1921,"Montréal, Quebec",Canada,978,544,422,966,1287
"Richard, Mike",F,07/09/1966,"Toronto, Ontario",Canada,7,0,2,2,2
"Richard, Tanner",F,04/06/1993,Jona,Switzerland,3,0,0,0,2
"Richards, Brad",F,05/02/1980,"Murray Harbour, Prince Edward Island",Canada,1126,298,634,932,251
"Richards, Justin",F,03/17/1998,"Columbus, Ohio",United States,1,0,1,1,0
"Richards, Mike",F,02/11/1985,"Kenora, Ontario",Canada,749,181,306,487,585
"Richards, Todd",D,10/20/1966,"Crystal, Minnesota",United States,8,0,4,4,4
"Richards, Travis",D,03/22/1970,"Crystal, Minnesota",United States,3,0,0,0,2
"Richardson, Brad",F,02/04/1985,"Belleville, Ontario",Canada,869,111,143,254,443
"Richardson, Dave",F,12/11/1940,"St. Boniface, Manitoba",Canada,45,3,2,5,25
"Richardson, Glen",F,09/20/1955,"Barrie, Ontario",Canada,24,3,6,9,19
"Richardson, Ken",F,04/12/1951,"North Bay, Ontario",Canada,49,8,13,21,16
"Richardson, Luke",D,03/26/1969,"Ottawa, Ontario",Canada,1417,35,166,201,2055
"Richardson, Terry",G,05/07/1953,"Powell River, British Columbia",Canada,20,0,1,1,6
"Richer, Bob",F,03/05/1951,"Cowansville, Quebec",Canada,3,0,0,0,0
"Richer, Stephane",F,04/28/1966,"Hull, Quebec",Canada,27,1,5,6,20
"Richer, Stephane",F,06/07/1966,"Ripon, Quebec",Canada,1054,421,398,819,614
"Richmond, Danny",D,08/01/1984,"Chicago, Illinois",United States,49,0,3,3,75
"Richmond, Steve",D,12/11/1959,"Chicago, Illinois",United States,159,4,23,27,514
"Richter, Barry",D,09/11/1970,"Madison, Wisconsin",United States,151,11,34,45,76
"Richter, Dave",D,04/08/1960,"St. Boniface, Manitoba",Canada,365,9,40,49,1030
"Richter, Mike",G,09/22/1966,"Abington, Pennsylvania",United States,666,0,11,11,34
"Ridley, Curt",G,09/23/1951,"Minnedosa, Manitoba",Canada,104,0,1,1,17
"Ridley, Mike",F,07/08/1963,"Winnipeg, Manitoba",Canada,866,292,466,758,424
"Rieder, Tobias",F,01/10/1993,Landshut,Germany,478,64,81,145,52
"Rielly, Morgan",D,03/09/1994,"West Vancouver, British Columbia",Canada,654,69,304,373,181
"Riendeau, Vincent",G,04/20/1966,"Saint-Hyacinthe, Quebec",Canada,184,0,4,4,14
"Riesen, Michel",F,04/11/1979,Oberbalm,Switzerland,12,0,1,1,4
"Riggin, Dennis",G,04/11/1936,"Kincardine, Ontario",Canada,18,0,0,0,0
"Riggin, Pat",G,05/26/1959,"Kincardine, Ontario",Canada,350,0,8,8,41
"Riikola, Juuso",D,11/09/1993,Joensuu,Finland,80,3,10,13,18
"Riley, Bill",F,09/20/1950,"Amherst, Nova Scotia",Canada,139,31,30,61,320
"Riley, Jack",F,12/29/1910,"Birchinlee, England",United Kingdom,103,10,22,32,8
"Riley, Jim",F,05/25/1895,"Bayfield, New Brunswick",Canada,9,0,2,2,10
"Rinaldo, Zac",F,06/15/1990,"Mississauga, Ontario",Canada,374,18,24,42,758
"Ring, Bob",G,10/06/1946,"Winchester, Massachusetts",United States,1,0,0,0,0
"Rinne, Pekka",G,11/03/1982,Kempele,Finland,683,1,14,15,56
"Riopelle, Howard",F,01/30/1922,"Ottawa, Ontario",Canada,169,27,16,43,71
"Rioux, Gerry",F,02/17/1959,"Iroquois Falls, Ontario",Canada,8,0,0,0,6
"Rioux, Pierre",F,02/01/1962,"Québec City, Quebec",Canada,14,1,2,3,4
"Ripley, Vic",F,05/30/1906,"Elgin, Ontario",Canada,280,51,49,100,170
"Risebrough, Doug",F,01/29/1954,"Guelph, Ontario",Canada,740,185,286,471,1542
"Rissanen, Rasmus",D,07/13/1991,Kuopio,Finland,6,0,0,0,4
"Rissling, Gary",F,08/08/1956,"Saskatoon, Saskatchewan",Canada,221,23,30,53,1006
"Rissmiller, Pat",F,10/26/1978,"Belmont, Massachusetts",United States,192,18,28,46,60
"Ristolainen, Rasmus",D,10/27/1994,Turku,Finland,608,48,213,261,329
"Rita, Jani",F,07/25/1981,Helsinki,Finland,66,9,5,14,10
"Ritchie, Bob",F,02/20/1955,"Laverlochere, Quebec",Canada,29,8,4,12,10
"Ritchie, Brett",F,07/01/1993,"Orangeville, Ontario",Canada,341,42,30,72,230
"Ritchie, Byron",F,04/24/1977,"Burnaby, British Columbia",Canada,324,25,33,58,373
"Ritchie, Dave",F,01/12/1892,"Montréal, Quebec",Canada,57,15,6,21,50
"Ritchie, Nick",F,12/05/1995,"Orangeville, Ontario",Canada,407,71,89,160,430
"Ritola, Mattias",F,03/14/1987,Borlänge,Sweden,43,4,5,9,17
"Ritson, Alex",F,03/07/1922,"Peace River, Alberta",Canada,1,0,0,0,0
"Rittich, David",G,08/19/1992,Jihlava,Czech Republic,151,0,1,1,26
"Rittinger, Alan",F,01/28/1925,"Regina, Saskatchewan",Canada,19,3,7,10,0
"Rivard, Bob",F,08/01/1939,"Sherbrooke, Quebec",Canada,27,5,12,17,4
"Rivard, Fern",G,01/18/1946,"Grand-Mere, Quebec",Canada,55,0,0,0,10
"Rivers, Gus",F,11/19/1909,"Winnipeg, Manitoba",Canada,88,4,5,9,10
"Rivers, Jamie",D,03/16/1975,"Ottawa, Ontario",Canada,454,17,49,66,385
"Rivers, Shawn",D,01/30/1971,"Ottawa, Ontario",Canada,4,0,2,2,2
"Rivers, Wayne",F,02/01/1942,"Hamilton, Ontario",Canada,108,15,30,45,94
"Rivet, Craig",D,09/13/1974,"North Bay, Ontario",Canada,923,50,187,237,1171
"Rizzuto, Garth",F,09/11/1947,"Trail, British Columbia",Canada,37,3,4,7,16
"Roach, Andy",D,08/22/1973,"Mattawan, Michigan",United States,5,1,2,3,10
"Roach, John",G,06/23/1900,"Port Perry, Ontario",Canada,491,0,1,1,0
"Roach, Mickey",F,05/01/1895,"Boston, Massachusetts",United States,211,77,37,114,54
"Robak, Colby",D,04/24/1990,"Dauphin, Manitoba",Canada,47,0,4,4,25
"Roberge, Mario",F,01/25/1964,"Québec City, Quebec",Canada,112,7,7,14,314
"Roberge, Serge",F,03/31/1965,"Québec City, Quebec",Canada,9,0,0,0,24
"Robert, Claude",F,08/10/1928,"Montréal, Quebec",Canada,23,1,0,1,9
"Robert, Rene",F,12/31/1948,"Trois-Rivières, Quebec",Canada,744,284,418,702,597
"Roberto, Phil",F,01/01/1949,"Niagara Falls, Ontario",Canada,385,75,106,181,464
"Roberts, David",F,05/28/1970,"Alameda, California",United States,125,20,33,53,85
"Roberts, Doug",D,10/28/1942,"Detroit, Michigan",United States,419,43,104,147,342
"Roberts, Gary",F,05/23/1966,"North York, Ontario",Canada,1224,438,472,910,2560
"Roberts, Gordie",D,10/02/1957,"Detroit, Michigan",United States,1097,61,359,420,1582
"Roberts, Jim",F,04/09/1940,"Toronto, Ontario",Canada,1006,126,194,320,623
"Roberts, Jim",F,06/08/1956,"Toronto, Ontario",Canada,106,17,23,40,33
"Roberts, Moe",G,12/13/1905,"Waterbury, Connecticut",United States,10,0,0,0,0
"Robertson, Earl",G,11/24/1910,"Bengough, Saskatchewan",Canada,190,0,0,0,0
"Robertson, Fred",D,10/22/1911,"Carlisle, England",United Kingdom,28,1,0,1,35
"Robertson, Geordie",F,08/01/1959,"Victoria, British Columbia",Canada,5,1,2,3,7
"Robertson, George",F,05/11/1928,"Winnipeg, Manitoba",Canada,31,2,5,7,6
"Robertson, Jason",F,07/22/1999,"Arcadia, California",United States,128,58,67,125,38
"Robertson, Nick",F,09/11/2001,"Northville, Michigan",United States,16,1,1,2,4
"Robertson, Torrie",F,08/02/1961,"Victoria, British Columbia",Canada,442,49,99,148,1751
"Robertsson, Bert",D,06/30/1974,Södertälje,Sweden,123,4,10,14,75
"Robidas, Stephane",D,03/03/1977,"Sherbrooke, Quebec",Canada,937,57,201,258,713
"Robidoux, Florent",F,05/05/1960,"Cypress River, Manitoba",Canada,52,7,4,11,75
"Robins, Bobby",F,10/17/1981,"Peshtigo, Wisconsin",United States,3,0,0,0,14
"Robinson, Buddy",F,09/30/1991,"Bellmawr, New Jersey",United States,53,3,6,9,32
"Robinson, Doug",F,08/27/1940,"St. Catharines, Ontario",Canada,240,44,67,111,36
"Robinson, Earl",F,03/11/1907,"Montréal, Quebec",Canada,419,83,98,181,153
"Robinson, Eric",F,06/14/1995,"Bellmawr, New Jersey",United States,187,25,32,57,34
"Robinson, Larry",D,06/02/1951,"Winchester, Ontario",Canada,1384,208,750,958,793
"Robinson, Moe",D,05/29/1957,"Winchester, Ontario",Canada,1,0,0,0,0
"Robinson, Nathan",F,12/31/1981,"Scarborough, Ontario",Canada,7,0,0,0,2
"Robinson, Rob",D,04/19/1967,"St. Catharines, Ontario",Canada,22,0,1,1,8
"Robinson, Scott",F,03/29/1964,"100 Mile House, British Columbia",Canada,1,0,0,0,2
"Robitaille, Louis",D,03/16/1982,"Montréal, Quebec",Canada,2,0,0,0,5
"Robitaille, Luc",F,02/17/1966,"Montréal, Quebec",Canada,1431,668,726,1394,1177
"Robitaille, Mike",D,02/12/1948,"Midland, Ontario",Canada,382,23,105,128,280
"Robitaille, Randy",F,10/12/1975,"Ottawa, Ontario",Canada,531,84,172,256,201
"Roche, Dave",F,06/13/1975,"Lindsay, Ontario",Canada,171,15,15,30,334
"Roche, Des",F,02/01/1909,"Kemptville, Ontario",Canada,113,20,18,38,54
"Roche, Earl",F,02/22/1910,"Prescott, Ontario",Canada,147,25,27,52,48
"Roche, Ernie",D,02/04/1930,"Montréal, Quebec",Canada,4,0,0,0,2
"Roche, Travis",D,06/17/1978,"Grande Cache, Alberta",Canada,60,6,14,20,24
"Rochefort, Dave",F,07/22/1946,"Red Deer, Alberta",Canada,1,0,0,0,0
"Rochefort, Leon",F,05/04/1939,"Cap-de-la-Madeleine, Quebec",Canada,617,121,147,268,93
"Rochefort, Normand",D,01/28/1961,"Trois-Rivières, Quebec",Canada,598,39,119,158,570
"Rockburn, Harvey",D,08/20/1908,"Ottawa, Ontario",Canada,94,4,3,7,264
"Rodden, Eddie",F,03/22/1901,"Mattawa, Ontario",Canada,90,6,14,20,60
"Rodewald, Jack",F,02/14/1994,"Winnipeg, Manitoba",Canada,10,0,0,0,2
"Rodgers, Marc",F,03/16/1972,"Shawville, Quebec",Canada,21,1,1,2,10
"Rödin, Anton",F,11/21/1990,Stockholm,Sweden,3,0,1,1,0
"Rodney, Bryan",D,04/22/1984,"London, Ontario",Canada,34,1,12,13,12
"Rodrigues, Evan",F,07/28/1993,"Toronto, Ontario",Canada,316,53,76,129,77
"Roenick, Jeremy",F,01/17/1970,"Boston, Massachusetts",United States,1363,513,703,1216,1463
"Roest, Stacy",F,03/15/1974,"Lethbridge, Alberta",Canada,244,28,48,76,54
"Rogers, John",F,04/10/1953,"Paradise Hill, Saskatchewan",Canada,14,2,4,6,0
"Rogers, Mike",F,10/24/1954,"Calgary, Alberta",Canada,484,202,317,519,184
"Rohlicek, Jeff",F,01/27/1966,"Park Ridge, Illinois",United States,9,0,0,0,8
"Rohlin, Leif",D,02/26/1968,Västerås,Sweden,96,8,24,32,40
"Rohloff, Jon",D,10/03/1969,"Mankato, Minnesota",United States,150,7,25,32,129
"Rohloff, Todd",D,01/16/1974,"Grand Rapids, Minnesota",United States,75,0,6,6,40
"Rolfe, Dale",D,04/30/1940,"Timmins, Ontario",Canada,509,25,125,150,556
"Rollins, Al",G,10/09/1926,"Vanguard, Saskatchewan",Canada,430,0,1,1,43
"Roloson, Dwayne",G,10/12/1969,"Simcoe, Ontario",Canada,606,0,14,14,96
"Rolston, Brian",F,02/21/1973,"Flint, Michigan",United States,1256,342,419,761,472
"Romanchych, Larry",F,09/07/1949,"Vancouver, British Columbia",Canada,298,68,97,165,102
"Romaniuk, Russ",F,06/09/1970,"Winnipeg, Manitoba",Canada,102,13,14,27,63
"Romano, Roberto",G,10/10/1962,"Montréal, Quebec",Canada,126,0,1,1,6
"Romanov, Alexander",D,01/06/2000,Moscow,Russia,133,4,15,19,74
"Rombough, Doug",F,07/08/1950,"Fergus, Ontario",Canada,150,24,27,51,80
"Rome, Aaron",D,09/27/1983,"Nesbitt, Manitoba",Canada,226,6,22,28,185
"Rominski, Dale",F,10/01/1975,"Farmington Hills, Michigan",United States,3,0,1,1,2
"Romnes, Elwyn 'Doc'",F,01/01/1909,"White Bear Lake, Minnesota",United States,360,67,137,204,40
"Ronan, Ed",F,03/21/1968,"Quincy, Massachusetts",United States,182,13,23,36,101
"Ronan, Skene",D,02/09/1889,"Ottawa, Ontario",Canada,11,0,0,0,6
"Ronning, Cliff",F,10/01/1965,"Burnaby, British Columbia",Canada,1137,306,563,869,453
"Rönnqvist, Jonas",F,08/22/1973,Kalix,Sweden,38,0,4,4,14
"Ronson, Len",F,07/08/1936,"Brantford, Ontario",Canada,18,2,1,3,10
"Ronty, Paul",F,06/12/1928,"Toronto, Ontario",Canada,488,101,211,312,103
"Rooney, Kevin",F,05/21/1993,"Canton, Massachusetts",United States,210,24,21,45,111
"Rooney, Steve",F,06/28/1962,"Canton, Massachusetts",United States,154,15,13,28,496
"Root, Bill",D,09/06/1959,"Toronto, Ontario",Canada,247,11,23,34,180
"Rosa, Pavel",F,06/07/1977,Most,Czech Republic,36,5,13,18,6
"Rosati, Mike",G,01/07/1968,"Toronto, Ontario",Canada,1,0,0,0,0
"Rosehill, Jay",D,07/16/1985,"Olds, Alberta",Canada,117,5,3,8,352
"Rosén, Calle",D,02/02/1994,Växjö,Sweden,38,3,9,12,12
"Roslovic, Jack",F,01/29/1997,"Columbus, Ohio",United States,309,60,86,146,44
"Ross, Art",D,01/13/1885,"Naughton, Ontario",Canada,3,1,0,1,12
"Ross, Jared",F,09/18/1982,"Huntsville, Alabama",United States,13,0,0,0,2
"Ross, Jim",D,05/20/1926,"Edinburgh, Scotland",United Kingdom,62,2,11,13,29
"Rossi, Marco",F,09/23/2001,Feldkirch,Austria,2,0,0,0,4
"Rossignol, Roly",F,10/18/1921,"Edmundston, New Brunswick",Canada,14,3,5,8,6
"Rossiter, Kyle",D,06/09/1980,"Edmonton, Alberta",Canada,11,0,1,1,9
"Rota, Darcy",F,02/16/1953,"Vancouver, British Columbia",Canada,794,256,239,495,973
"Rota, Randy",F,08/16/1950,"Creston, British Columbia",Canada,212,38,39,77,60
"Rothschild, Sammy",F,10/16/1899,"Sudbury, Ontario",Canada,100,8,7,15,25
"Roulston, Rolly",D,04/12/1911,"Toronto, Ontario",Canada,24,0,6,6,10
"Roulston, Tom",F,11/20/1957,"Winnipeg, Manitoba",Canada,195,47,49,96,74
"Roupe, Magnus",F,03/23/1963,Stockholm,Sweden,40,3,5,8,42
"Rourke, Allan",D,03/06/1980,"Mississauga, Ontario",Canada,55,1,4,5,31
"Rouse, Bob",D,06/18/1964,"Surrey, British Columbia",Canada,1061,37,181,218,1561
"Rousseau, Bobby",F,07/26/1940,"Montréal, Quebec",Canada,942,245,458,703,357
"Rousseau, Guy",F,12/21/1934,"Montréal, Quebec",Canada,4,0,1,1,2
"Rousseau, Roland",D,12/01/1929,"Montréal, Quebec",Canada,2,0,0,0,0
"Roussel, Antoine",F,11/21/1989,Roubaix,France,607,85,112,197,1063
"Roussel, Dominic",G,02/22/1970,"Hull, Quebec",Canada,205,0,4,4,33
"Routhier, Jean-Marc",F,02/02/1968,"Québec City, Quebec",Canada,8,0,0,0,9
"Rowe, Bobby",D,08/19/1885,"Heathcote, Ontario",Canada,4,1,0,1,0
"Rowe, Mike",D,03/08/1965,"Kingston, Ontario",Canada,11,0,0,0,11
"Rowe, Ron",F,11/30/1923,"Toronto, Ontario",Canada,5,1,0,1,0
"Rowe, Tom",F,05/23/1956,"Lynn, Massachusetts",United States,357,85,100,185,615
"Rowney, Carter",F,05/10/1989,"Grande Prairie, Alberta",Canada,249,24,39,63,36
"Roy, Andre",F,02/08/1975,"Port Chester, New York",United States,515,35,33,68,1169
"Roy, Derek",F,05/04/1983,"Ottawa, Ontario",Canada,738,189,335,524,391
"Roy, Jean-Yves",F,02/17/1969,"Rosemère, Quebec",Canada,61,12,16,28,26
"Roy, Kevin",F,05/20/1993,"Lac-Beauport, Quebec",Canada,28,6,1,7,6
"Roy, Mathieu",D,08/10/1983,"Saint-Georges, Quebec",Canada,66,2,11,13,76
"Roy, Matt",D,03/01/1995,"Canton, Michigan",United States,206,10,45,55,54
"Roy, Nicolas",F,02/05/1997,"Amos, Quebec",Canada,163,26,38,64,75
"Roy, Patrick",G,10/05/1965,"Québec City, Quebec",Canada,1029,0,45,45,262
"Roy, Stephane",F,06/29/1967,"Sainte-Martine, Quebec",Canada,12,1,0,1,0
"Royer, Gaetan",F,03/13/1976,"Donnacona, Quebec",Canada,3,0,0,0,2
"Royer, Remi",D,02/12/1978,"Donnacona, Quebec",Canada,18,0,0,0,67
"Rozsíval, Michal",D,09/03/1978,Vlasim,Czech Republic,963,68,241,309,704
"Rozzini, Gino",F,10/24/1918,"Shawinigan, Quebec",Canada,31,5,10,15,20
"Rubins, Kristians",D,12/11/1997,Riga,Latvia,3,0,0,0,4
"Rubtsov, German",F,06/27/1998,Chekhov,Russia,4,0,0,0,0
"Rucchin, Steve",F,07/04/1971,"Thunder Bay, Ontario",Canada,735,171,318,489,164
"Rucinski, Mike",D,03/30/1975,"Trenton, Michigan",United States,26,0,2,2,10
"Rucinski, Mike",F,12/12/1963,"Wheeling, Illinois",United States,1,0,0,0,0
"Rucínský, Martin",F,03/11/1971,Most,Czech Republic,961,241,371,612,821
"Rudkowsky, Cody",G,07/21/1978,"Willingdon, Alberta",Canada,1,0,0,0,0
"Ruelle, Bernard",F,11/23/1920,"Houghton, Michigan",United States,2,1,0,1,0
"Ruff, Jason",F,01/27/1970,"Kelowna, British Columbia",Canada,14,3,3,6,10
"Ruff, Lindy",F,02/17/1960,"Warburg, Alberta",Canada,691,105,195,300,1266
"Ruhnke, Kent",F,09/18/1952,"Toronto, Ontario",Canada,2,0,1,1,0
"Ruhwedel, Chad",D,05/07/1990,"San Diego, California",United States,265,11,29,40,72
"Rumble, Darren",D,01/23/1969,"Barrie, Ontario",Canada,193,10,26,36,216
"Rundblad, David",D,10/08/1990,Lycksele,Sweden,113,4,21,25,30
"Rundqvist, Thomas",F,05/04/1960,Vimmerby,Sweden,2,0,1,1,0
"Runge, Paul",F,09/10/1908,"Edmonton, Alberta",Canada,142,18,22,40,57
"Ruotsalainen, Arttu",F,10/29/1997,Oulu,Finland,35,7,3,10,14
"Ruotsalainen, Reijo",D,04/01/1960,Oulu,Finland,446,107,237,344,180
"Rupp, Duane",D,03/29/1938,"MacNutt, Saskatchewan",Canada,374,24,93,117,220
"Rupp, Michael",F,01/13/1980,"Cleveland, Ohio",United States,610,54,45,99,855
"Rupp, Pat",G,08/12/1942,"Detroit, Michigan",United States,1,0,0,0,0
"Ruskowski, Terry",F,12/31/1954,"Prince Albert, Saskatchewan",Canada,629,113,313,426,1354
"Russell, Cam",D,01/12/1969,"Halifax, Nova Scotia",Canada,396,9,21,30,872
"Russell, Church",F,03/16/1923,"Winnipeg, Manitoba",Canada,90,20,16,36,12
"Russell, Kris",D,05/02/1987,"Red Deer, Alberta",Canada,912,48,206,254,271
"Russell, Patrick",F,01/04/1993,Birkerød,Denmark,59,0,7,7,14
"Russell, Phil",D,07/21/1952,"Edmonton, Alberta",Canada,1016,99,325,424,2038
"Russell, Ryan",F,05/02/1987,"Caroline, Alberta",Canada,41,2,0,2,2
"Russo, Robbie",D,02/15/1993,"Westmont, Illinois",United States,19,0,0,0,2
"Rust, Bryan",F,05/14/1992,"Pontiac, Michigan",United States,424,124,146,270,136
"Rutherford, Jim",G,02/17/1949,"Beeton, Ontario",Canada,457,0,15,15,62
"Rutledge, Wayne",G,01/05/1942,"Barrie, Ontario",Canada,82,0,0,0,11
"Rutta, Jan",D,07/29/1990,Pisek,Czech Republic,238,12,49,61,123
"Ruuttu, Christian",F,02/20/1964,Lappeenranta,Finland,621,134,298,432,714
"Ruutu, Jarkko",F,08/23/1975,Vantaa,Finland,652,58,84,142,1078
"Ruutu, Tuomo",F,02/16/1983,Vantaa,Finland,735,148,198,346,596
"Ruzicka, Adam",F,05/11/1999,Bratislava,Slovakia,31,5,6,11,12
"Ruzicka, Stefan",F,02/17/1985,Nitra,Slovakia,55,4,13,17,47
"Ruzicka, Vladimir",F,06/06/1963,Most,Czech Republic,233,82,85,167,129
"Ryan, Bobby",F,03/17/1987,"Cherry Hill, New Jersey",United States,866,261,308,569,470
"Ryan, Derek",F,12/29/1986,"Spokane, Washington",United States,420,63,108,171,110
"Ryan, Joakim",D,06/17/1993,"Rumson, New Jersey",United States,145,4,20,24,33
"Ryan, Matt",F,11/12/1983,"Sharon, Ontario",Canada,12,0,1,1,2
"Ryan, Michael",F,05/16/1980,"Boston, Massachusetts",United States,83,7,8,15,34
"Ryan, Prestin",D,06/29/1980,"Arcola, Saskatchewan",Canada,1,0,0,0,2
"Ryan, Terry",F,01/14/1977,"St. John's, Newfoundland and Labrador",Canada,8,0,0,0,36
"Rychel, Kerby",F,10/07/1994,"Los Angeles, California",United States,43,3,11,14,19
"Rychel, Warren",F,05/12/1967,"Tecumseh, Ontario",Canada,406,38,39,77,1422
"Rycroft, Mark",F,07/12/1978,"Penticton, British Columbia",Canada,226,21,25,46,113
"Ryder, Michael",F,03/31/1980,"St. John's, Newfoundland and Labrador",Canada,806,237,247,484,353
"Rymsha, Andy",D,12/10/1968,"St. Catharines, Ontario",Canada,6,0,0,0,23
"Rymsha, Drake",F,08/06/1998,"Huntington Woods, Michigan",United States,1,0,0,0,0
"Rynnäs, Jussi",G,05/22/1987,Pori,Finland,5,0,0,0,0
"Rypien, Rick",F,05/16/1984,"Coleman, Alberta",Canada,119,9,7,16,226
"Ryznar, Jason",F,02/19/1983,"Anchorage, Alaska",United States,8,0,0,0,2
"Røndbjerg, Jonas",F,03/31/1999,Hørsholm,Denmark,30,2,4,6,4
"Saad, Brandon",F,10/27/1992,"Pittsburgh, Pennsylvania",United States,710,208,212,420,130
"Saarela, Aleksi",F,01/07/1997,Helsinki,Finland,9,2,2,4,0
"Saarinen, Simo",D,02/14/1963,Helsinki,Finland,8,0,0,0,8
"Sabol, Shawn",D,07/13/1966,"Minneapolis, Minnesota",United States,2,0,0,0,0
"Sabourin, Bob",F,03/17/1933,"Sudbury, Ontario",Canada,1,0,0,0,2
"Sabourin, Dany",G,09/02/1980,"Val-d'Or, Quebec",Canada,57,0,1,1,4
"Sabourin, Gary",F,12/04/1943,"Parry Sound, Ontario",Canada,627,169,188,357,397
"Sabourin, Ken",D,04/28/1966,"Scarborough, Ontario",Canada,74,2,8,10,201
"Sabourin, Scott",F,07/30/1992,"Orleans, Ontario",Canada,43,2,6,8,49
"Sacco, David",F,07/31/1971,"Malden, Massachusetts",United States,35,5,13,18,22
"Sacco, Joe",F,02/04/1969,"Medford, Massachusetts",United States,738,94,119,213,421
"Sacharuk, Larry",D,09/16/1952,"Saskatoon, Saskatchewan",Canada,151,29,33,62,42
"Safronov, Kirill",D,02/26/1981,Saint Petersburg,Russia,35,2,2,4,16
"Saganiuk, Rocky",F,10/15/1957,"Myrnam, Alberta",Canada,259,57,65,122,201
"Sakic, Joe",F,07/07/1969,"Burnaby, British Columbia",Canada,1378,625,1016,1641,614
"Salak, Alexander",G,01/05/1987,Strakonice,Czech Republic,2,0,0,0,0
"Salcido, Brian",D,04/14/1985,"Hermosa Beach, California",United States,2,0,1,1,0
"Salei, Ruslan",D,11/02/1974,Minsk,Belarus,917,45,159,204,1065
"Saleski, Don",F,11/10/1949,"Moose Jaw, Saskatchewan",Canada,543,128,125,253,629
"Salmela, Anssi",D,08/13/1984,Nokia,Finland,112,4,17,21,44
"Salmelainen, Tony",F,08/08/1981,Espoo,Finland,70,6,12,18,30
"Salming, Börje",D,04/17/1951,Kiruna,Sweden,1148,150,637,787,1344
"Salo, Robin",D,10/13/1998,Espoo,Finland,21,1,4,5,4
"Salo, Sami",D,09/02/1974,Turku,Finland,878,99,240,339,286
"Salo, Tommy",G,02/01/1971,Surahammar,Sweden,526,0,7,7,67
"Salomäki, Miikka",F,03/09/1993,Raahe,Finland,167,12,15,27,76
"Salomonsson, Andreas",F,12/19/1973,Örnsköldsvik,Sweden,71,5,9,14,36
"Salovaara, Barry",D,01/07/1948,"Cooksville, Ontario",Canada,90,2,13,15,70
"Salvador, Bryce",D,02/11/1976,"Brandon, Manitoba",Canada,786,24,86,110,696
"Samberg, Dylan",D,01/24/1999,"Saginaw, Minnesota",United States,15,0,5,5,4
"Samis, Phil",D,12/28/1927,"Edmonton, Alberta",Canada,2,0,0,0,0
"Samorukov, Dmitri",D,06/16/1999,Volgograd,Russia,1,0,0,0,0
"Sampson, Gary",F,08/24/1959,"Atikokan, Ontario",Canada,105,13,22,35,25
"Samson, Jerome",F,09/04/1987,"Greenfield Park, Quebec",Canada,46,2,7,9,18
"Samsonov, Ilya",G,02/22/1997,Magnitogorsk,Russia,89,0,1,1,2
"Samsonov, Sergei",F,10/27/1978,Moscow,Russia,888,235,336,571,209
"Samuelsson, Henrik",F,02/07/1994,"Pittsburgh, Pennsylvania",United States,3,0,0,0,2
"Samuelsson, Kjell",D,10/18/1958,Tingsryd,Sweden,813,48,138,186,1225
"Samuelsson, Martin",F,01/25/1982,Upplands Väsby,Sweden,14,0,1,1,2
"Samuelsson, Mattias",D,03/14/2000,"Voorhees Township, New Jersey",United States,54,0,12,12,20
"Samuelsson, Mikael",F,12/23/1976,Mariefred,Sweden,699,149,197,346,370
"Samuelsson, Philip",D,07/26/1991,Leksand,Sweden,13,0,0,0,2
"Samuelsson, Ulf",D,03/26/1964,Fagersta,Sweden,1080,57,275,332,2453
"Sandelin, Scott",D,08/08/1964,"Hibbing, Minnesota",United States,25,0,4,4,2
"Sanderson, Derek",F,06/16/1946,"Niagara Falls, Ontario",Canada,598,202,250,452,911
"Sanderson, Geoff",F,02/01/1972,"Hay River, Northwest Territories",Canada,1104,355,345,700,511
"Sandford, Ed",F,08/20/1928,"New Toronto, Ontario",Canada,503,106,145,251,355
"Sandin, Linus",F,05/19/1996,Uppsala,Sweden,1,0,0,0,0
"Sandin, Rasmus",D,03/07/2000,Uppsala,Sweden,88,6,22,28,14
"Sandlak, Jim",F,12/12/1966,"Kitchener, Ontario",Canada,549,110,119,229,821
"Sands, Charlie",F,03/23/1911,"Thunder Bay, Ontario",Canada,429,99,112,211,56
"Sands, Mike",G,04/06/1963,"Mississauga, Ontario",Canada,6,0,0,0,2
"Sandström, Felix",G,01/12/1997,Gävle,Sweden,5,0,0,0,0
"Sandström, Tomas",F,09/04/1964,Pietarsaari,Finland,983,394,462,856,1193
"Sandwith, Terran",D,04/17/1972,"Edmonton, Alberta",Canada,8,0,0,0,6
"Sanford, Curtis",G,10/05/1979,"Owen Sound, Ontario",Canada,144,0,1,1,4
"Sanford, Zachary",F,11/09/1994,"Salem, Massachusetts",United States,289,47,48,95,134
"Sanguinetti, Bobby",D,02/29/1988,"Trenton, New Jersey",United States,45,2,4,6,8
"Sanheim, Travis",D,03/29/1996,"Elkhorn, Manitoba",Canada,335,29,87,116,131
"Sanipass, Everett",F,02/13/1968,"Big Cove, New Brunswick",Canada,164,25,34,59,358
"Santala, Tommi",F,06/27/1979,Helsinki,Finland,63,2,7,9,46
"Santini, Steve",D,03/07/1995,"Mahopac, New York",United States,119,5,17,22,55
"Santorelli, Michael",F,12/14/1985,"Vancouver, British Columbia",Canada,406,64,74,138,78
"Saprykin, Oleg",F,02/12/1981,Moscow,Russia,325,55,82,137,240
"Sarault, Yves",F,12/23/1972,"Salaberry-de-Valleyfield, Quebec",Canada,106,10,10,20,51
"Sargent, Gary",D,02/18/1954,"Red Lake, Minnesota",United States,402,61,161,222,273
"Sarich, Cory",D,08/16/1978,"Saskatoon, Saskatchewan",Canada,969,21,137,158,1089
"Sarjeant, Geoff",G,11/30/1969,"Newmarket, Ontario",Canada,8,0,1,1,4
"Sarner, Craig",F,06/20/1949,"St. Paul, Minnesota",United States,7,0,0,0,0
"Sarno, Peter",F,07/26/1979,"Toronto, Ontario",Canada,7,1,0,1,2
"Saros, Juuse",G,04/19/1995,Forssa,Finland,222,0,4,4,2
"Sarrazin, Dick",F,01/22/1946,"Saint-Gabriel-de-Brandon, Quebec",Canada,100,20,35,55,22
"Sasakamoose, Fred",F,12/25/1933,"Sandy Lake, Saskatchewan",Canada,11,0,0,0,6
"Sasser, Grant",F,02/13/1964,"Portland, Oregon",United States,3,0,0,0,0
"Satan, Miroslav",F,10/22/1974,Topolcany,Slovakia,1050,363,372,735,464
"Säteri, Harri",G,12/29/1989,Toijala,Finland,15,0,0,0,0
"Sather, Glen",F,09/02/1943,"High River, Alberta",Canada,658,80,113,193,724
"Sauer, Kurt",D,01/16/1981,"St. Cloud, Minnesota",United States,357,5,28,33,250
"Sauer, Mike",D,08/07/1987,"St. Cloud, Minnesota",United States,98,4,14,18,96
"Saunders, Bernie",F,06/21/1956,"Montréal, Quebec",Canada,10,0,1,1,8
"Saunders, David",F,05/20/1966,"Ottawa, Ontario",Canada,56,7,13,20,10
"Saunders, Ted",F,08/29/1911,"Ottawa, Ontario",Canada,18,1,3,4,4
"Sautner, Ashton",D,05/27/1994,"Wolseley, Saskatchewan",Canada,23,0,3,3,4
"Sauve, Bob",G,06/17/1955,"Sainte-Genevieve, Quebec",Canada,420,0,15,15,57
"Sauve, Jean-Francois",F,01/23/1960,"Sainte-Genevieve, Quebec",Canada,290,65,138,203,117
"Sauve, Max",F,01/30/1990,Tours,France,1,0,0,0,0
"Sauve, Philippe",G,02/27/1980,"Buffalo, New York",United States,32,0,0,0,23
"Sauve, Yann",D,02/18/1990,"Montréal, Quebec",Canada,8,0,0,0,0
"Savage, Andre",F,05/27/1975,"Ottawa, Ontario",Canada,66,10,14,24,14
"Savage, Brian",F,02/24/1971,"Sudbury, Ontario",Canada,674,192,167,359,321
"Savage, Joel",F,12/25/1969,"Surrey, British Columbia",Canada,3,0,1,1,0
"Savage, Reggie",F,05/01/1970,"Montréal, Quebec",Canada,34,5,7,12,28
"Savage, Tony",D,07/18/1906,"Calgary, Alberta",Canada,49,1,5,6,16
"Savard, Andre",F,09/02/1953,"Temiscaming, Quebec",Canada,790,211,271,482,411
"Savard, David",D,10/22/1990,"Saint-Hyacinthe, Quebec",Canada,673,44,139,183,367
"Savard, Denis",F,02/04/1961,"Pointe Gatineau, Quebec",Canada,1196,473,865,1338,1336
"Savard, Jean",F,04/26/1957,"Verdun, Quebec",Canada,43,7,12,19,29
"Savard, Marc",F,07/17/1977,"Ottawa, Ontario",Canada,807,207,499,706,737
"Savard, Serge",D,01/22/1946,"Montréal, Quebec",Canada,1040,106,333,439,590
"Savoia, Ryan",F,05/06/1973,"Thorold, Ontario",Canada,3,0,0,0,0
"Sawada, Raymond",F,02/19/1985,"Richmond, British Columbia",Canada,11,1,0,1,0
"Sawchenko, Zach",G,12/30/1997,"Calgary, Alberta",Canada,7,0,0,0,0
"Sawchuk, Terry",G,12/28/1929,"Winnipeg, Manitoba",Canada,971,0,7,7,225
"Sawyer, Kevin",F,02/21/1974,"Christina Lake, British Columbia",Canada,110,3,3,6,403
"Sbisa, Luca",D,01/30/1990,Ozieri,Italy,549,20,93,113,385
"Scamurra, Peter",D,02/23/1955,"Buffalo, New York",United States,132,8,25,33,59
"Scandella, Marco",D,02/23/1990,"Montréal, Quebec",Canada,699,48,112,160,273
"Scatchard, Dave",F,02/20/1976,"Hinton, Alberta",Canada,659,128,141,269,1040
"Sceviour, Colton",F,04/20/1989,"Red Deer, Alberta",Canada,535,66,90,156,136
"Sceviour, Darin",F,11/30/1965,"Lacombe, Alberta",Canada,1,0,0,0,0
"Schaefer, Joe",G,12/21/1924,"Long Island, New York",United States,2,0,0,0,0
"Schaefer, Nolan",G,01/15/1980,"Yellow Grass, Saskatchewan",Canada,7,0,0,0,2
"Schaefer, Peter",F,07/12/1977,"Regina, Saskatchewan",Canada,572,99,162,261,200
"Schaeffer, Butch",D,11/07/1911,"Hinkley, Minnesota",United States,5,0,0,0,6
"Schafer, Paxton",G,02/26/1976,"Medicine Hat, Alberta",Canada,3,0,0,0,0
"Schaller, Tim",F,11/16/1990,"Merrimack, New Hampshire",United States,276,29,28,57,92
"Schamehorn, Kevin",F,07/28/1956,"Calgary, Alberta",Canada,10,0,0,0,17
"Schastlivy, Petr",F,04/18/1979,Angarsk,Russia,129,18,22,40,30
"Scheifele, Mark",F,03/15/1993,"Kitchener, Ontario",Canada,642,230,347,577,260
"Schella, John",D,05/09/1947,"Thunder Bay, Ontario",Canada,115,2,18,20,224
"Schenn, Brayden",F,08/22/1991,"Saskatoon, Saskatchewan",Canada,776,219,305,524,425
"Schenn, Luke",D,11/02/1989,"Saskatoon, Saskatchewan",Canada,863,38,131,169,680
"Scherbak, Nikita",F,12/30/1995,Moscow,Russia,37,6,2,8,10
"Scherza, Chuck",F,02/15/1923,"Brandon, Manitoba",Canada,36,6,6,12,35
"Schilling, Cameron",D,10/07/1988,"Carmel, Indiana",United States,10,0,1,1,4
"Schinkel, Ken",F,11/27/1932,"Jansen, Saskatchewan",Canada,636,127,198,325,163
"Schlegel, Brad",D,07/22/1968,"Kitchener, Ontario",Canada,48,1,8,9,10
"Schlemko, David",D,05/07/1987,"Edmonton, Alberta",Canada,415,18,76,94,124
"Schliebener, Andy",D,08/16/1962,"Ottawa, Ontario",Canada,84,2,11,13,74
"Schmaltz, Jordan",D,10/08/1993,"Verona, Wisconsin",United States,42,0,5,5,12
"Schmaltz, Nick",F,02/23/1996,"Madison, Wisconsin",United States,364,78,163,241,82
"Schmautz, Bobby",F,03/28/1945,"Saskatoon, Saskatchewan",Canada,764,271,286,557,988
"Schmautz, Cliff",F,03/17/1939,"Saskatoon, Saskatchewan",Canada,57,13,19,32,33
"Schmid, Akira",G,05/12/2000,Nesslau-Krummenau,Switzerland,6,0,0,0,0
"Schmidt, Chris",F,03/01/1976,"Beaverlodge, Alberta",Canada,10,0,2,2,5
"Schmidt, Clarence",F,09/17/1925,"Williams, Minnesota",United States,7,1,0,1,2
"Schmidt, Jackie",F,11/11/1924,"Odessa, Saskatchewan",Canada,45,6,7,13,6
"Schmidt, Milt",F,03/05/1918,"Kitchener, Ontario",Canada,776,229,346,575,466
"Schmidt, Nate",D,07/16/1991,"St. Cloud, Minnesota",United States,527,38,149,187,98
"Schmidt, Norm",D,01/24/1963,"Sault Ste. Marie, Ontario",Canada,125,23,33,56,73
"Schmidt, Otto",F,11/05/1926,"Odessa, Saskatchewan",Canada,2,0,0,0,0
"Schnabel, Robert",D,11/10/1978,Prague,Czech Republic,22,0,3,3,34
"Schnarr, Werner",F,03/23/1903,"Kitchener, Ontario",Canada,26,0,0,0,0
"Schneider, Andy",F,03/29/1972,"Edmonton, Alberta",Canada,10,0,0,0,15
"Schneider, Braden",D,09/20/2001,"Prince Albert, Saskatchewan",Canada,43,2,9,11,9
"Schneider, Cole",F,08/26/1990,"Williamsville, New York",United States,6,0,1,1,0
"Schneider, Cory",G,03/18/1986,"Marblehead, Massachusetts",United States,410,0,9,9,4
"Schneider, Mathieu",D,06/12/1969,"New York, New York",United States,1289,223,520,743,1245
"Schock, Danny",F,12/30/1948,"Terrace Bay, Ontario",Canada,20,1,2,3,0
"Schock, Ron",F,12/19/1943,"Chapleau, Ontario",Canada,909,166,351,517,258
"Schoenfeld, Jim",D,09/04/1952,"Galt, Ontario",Canada,719,51,204,255,1132
"Schofield, Dwight",D,03/25/1956,"Waltham, Massachusetts",United States,211,8,22,30,628
"Schreiber, Wally",F,04/15/1962,"Edmonton, Alberta",Canada,41,8,10,18,12
"Schremp, Rob",F,07/01/1986,"Syracuse, New York",United States,114,20,34,54,26
"Schriner, Sweeney",F,11/30/1911,Saratov,Russia,484,201,206,407,148
"Schroeder, Jordan",F,09/29/1990,"Lakeville, Minnesota",United States,165,18,24,42,14
"Schubert, Christoph",D,02/05/1982,Munich,Germany,315,25,47,72,263
"Schueneman, Corey",D,09/02/1995,"Milford, Michigan",United States,24,2,4,6,8
"Schuldt, James",D,05/11/1995,"Minnetonka, Minnesota",United States,1,0,1,1,0
"Schulte, Paxton",F,07/16/1972,"Onoway, Alberta",Canada,2,0,0,0,4
"Schultz, Dave",F,10/14/1949,"Waldheim, Saskatchewan",Canada,535,79,121,200,2292
"Schultz, Jeff",D,02/25/1986,"Calgary, Alberta",Canada,409,11,65,76,137
"Schultz, Jesse",F,09/28/1982,"Strasbourg, Saskatchewan",Canada,2,0,0,0,0
"Schultz, Justin",D,07/06/1990,"Kelowna, British Columbia",Canada,602,57,207,264,136
"Schultz, Nick",D,08/25/1982,"Strasbourg, Saskatchewan",Canada,1069,30,145,175,483
"Schultz, Ray",D,11/14/1976,"Red Deer, Alberta",Canada,45,0,4,4,155
"Schurman, Maynard",F,07/16/1957,"Summerside, Prince Edward Island",Canada,7,0,0,0,0
"Schutt, Rod",F,10/13/1956,"Bancroft, Ontario",Canada,286,77,92,169,177
"Schwab, Corey",G,11/04/1970,"North Battleford, Saskatchewan",Canada,147,0,6,6,53
"Schwartz, Jaden",F,06/25/1992,"Melfort, Saskatchewan",Canada,597,162,246,408,167
"Schwarz, Marek",G,04/01/1986,Mlada Boleslav,Czech Republic,6,0,0,0,0
"Schwindt, Cole",F,04/25/2001,"Kitchener, Ontario",Canada,3,0,0,0,0
"Scissons, Scott",F,10/29/1971,"Saskatoon, Saskatchewan",Canada,2,0,0,0,0
"Sclisizzi, Enio",F,08/01/1925,"Milton, Ontario",Canada,81,12,11,23,26
"Scott, Ganton",F,03/23/1903,"Preston, Ontario",Canada,57,1,1,2,0
"Scott, John",D,09/26/1982,"St. Catharines, Ontario",Canada,286,5,6,11,544
"Scott, Laurie",F,06/19/1900,"South River, Ontario",Canada,62,6,3,9,28
"Scott, Richard",F,08/01/1978,"Orillia, Ontario",Canada,10,0,0,0,28
"Scott, Ron",G,07/21/1960,"Guelph, Ontario",Canada,28,0,0,0,2
"Scott, Travis",G,09/14/1975,"Kanata, Ontario",Canada,1,0,0,0,0
"Scoville, Darrel",D,10/13/1975,"Swift Current, Saskatchewan",Canada,16,0,1,1,12
"Scremin, Claudio",D,05/28/1968,"Burnaby, British Columbia",Canada,17,0,1,1,29
"Scrivens, Ben",G,09/11/1986,"Spruce Grove, Alberta",Canada,144,0,2,2,20
"Scruton, Howard",D,10/06/1962,"Toronto, Ontario",Canada,4,0,4,4,9
"Scuderi, Rob",D,12/30/1978,"Syosset, New York",United States,783,8,102,110,198
"Seabrook, Brent",D,04/20/1985,"Richmond, British Columbia",Canada,1114,103,361,464,661
"Seabrooke, Glen",F,09/11/1967,"Peterborough, Ontario",Canada,19,1,6,7,4
"Secord, Al",F,03/03/1958,"Sudbury, Ontario",Canada,766,273,223,496,2095
"Sedin, Daniel",F,09/26/1980,Örnsköldsvik,Sweden,1306,393,648,1041,546
"Sedin, Henrik",F,09/26/1980,Örnsköldsvik,Sweden,1330,240,830,1070,680
"Sedlak, Lukas",F,02/25/1993,Ceske Budejovice,Czech Republic,162,15,12,27,56
"Sedlbauer, Ron",F,10/22/1954,"Burlington, Ontario",Canada,430,143,86,229,210
"Seeler, Nick",D,06/03/1993,"Eden Prairie, Minnesota",United States,148,3,12,15,129
"Seftel, Steve",F,05/14/1968,"Kitchener, Ontario",Canada,4,0,0,0,2
"Segal, Brandon",F,07/12/1983,"Richmond, British Columbia",Canada,103,11,11,22,85
"Seguin, Dan",F,06/07/1948,"Sudbury, Ontario",Canada,37,2,6,8,50
"Seguin, Steve",F,04/10/1964,"Cornwall, Ontario",Canada,5,0,0,0,9
"Seguin, Tyler",F,01/31/1992,"Brampton, Ontario",Canada,825,305,381,686,253
"Seibert, Earl",D,12/07/1911,"Kitchener, Ontario",Canada,657,89,187,276,766
"Seidenberg, Dennis",D,07/18/1981,Schwenningen,Germany,859,44,207,251,359
"Seider, Moritz",D,04/06/2001,Zell,Germany,82,7,43,50,34
"Seiling, Ric",F,12/15/1957,"Elmira, Ontario",Canada,738,179,208,387,573
"Seiling, Rod",D,11/14/1944,"Kitchener, Ontario",Canada,979,62,269,331,603
"Sejba, Jirí",F,07/22/1962,Pardubice,Czech Republic,11,0,2,2,8
"Sejna, Peter",F,10/05/1979,Liptovsky Mikulas,Slovakia,49,7,4,11,12
"Sekac, Jiri",F,06/10/1992,Kladno,Czech Republic,108,10,19,29,38
"Sekera, Andrej",D,06/08/1986,Bojnice,Slovakia,842,51,202,253,212
"Sekeras, Lubomir",D,11/18/1968,Trencín,Slovakia,213,18,53,71,122
"Selänne, Teemu",F,07/03/1970,Helsinki,Finland,1451,684,773,1457,660
"Selby, Brit",F,03/27/1945,"Kingston, Ontario",Canada,347,55,62,117,171
"Self, Steve",F,05/09/1950,"Peterborough, Ontario",Canada,3,0,0,0,0
"Selivanov, Alexander",F,03/23/1971,Moscow,Russia,459,121,114,235,379
"Sellars, Luke",D,05/21/1981,"Toronto, Ontario",Canada,1,0,0,0,2
"Selleck, Eric",F,10/20/1987,"Spencerville, Ontario",Canada,3,0,1,1,22
"Selmser, Sean",F,11/10/1974,"Calgary, Alberta",Canada,1,0,0,0,5
"Selwood, Brad",D,03/18/1948,"Leamington, Ontario",Canada,162,7,40,47,153
"Semak, Alexander",F,02/11/1966,Ufa,Russia,289,83,91,174,187
"Semchuk, Brandy",F,09/22/1971,"Calgary, Alberta",Canada,1,0,0,0,2
"Semenko, Dave",F,07/12/1957,"Winnipeg, Manitoba",Canada,575,65,88,153,1175
"Semenov, Alexei",D,04/10/1981,Murmansk,Russia,211,7,26,33,249
"Semenov, Anatoli",F,03/05/1962,Moscow,Russia,362,68,126,194,122
"Semin, Alexander",F,03/03/1984,Krasnoyarsk,Russia,650,239,278,517,582
"Semyonov, Kirill",F,10/27/1994,Omsk,Russia,3,0,0,0,0
"Seney, Brett",F,02/29/1996,"London, Ontario",Canada,55,5,8,13,31
"Senick, George",F,09/16/1929,"Saskatoon, Saskatchewan",Canada,13,2,3,5,8
"Senn, Gilles",G,03/01/1996,Bülach,Switzerland,2,0,0,0,0
"Senyshyn, Zach",F,03/30/1997,"Ottawa, Ontario",Canada,16,1,2,3,4
"Seppä, Jyrki",D,11/14/1961,Tampere,Finland,13,0,2,2,6
"Serafini, Ron",D,10/31/1953,"Highland Park, Michigan",United States,2,0,0,0,2
"Sergachyov, Mikhail",D,06/25/1998,Nizhnekamsk,Russia,362,36,138,174,213
"Serowik, Jeff",D,01/10/1967,"Manchester, New Hampshire",United States,28,0,6,6,16
"Servinis, George",F,04/29/1962,"Toronto, Ontario",Canada,5,0,0,0,0
"Sestito, Tim",F,08/28/1984,"Rome, New York",United States,101,0,8,8,55
"Sestito, Tommy",F,09/28/1987,"Utica, New York",United States,154,10,11,21,499
"Setoguchi, Devin",F,01/01/1987,"Taber, Alberta",Canada,516,131,130,261,177
"Sevcik, Jaroslav",F,05/15/1965,Brno,Czech Republic,13,0,2,2,2
"Severson, Cam",F,01/15/1978,"Canora, Saskatchewan",Canada,37,3,0,3,63
"Severson, Damon",D,08/07/1994,"Brandon, Manitoba",Canada,566,51,179,230,350
"Severyn, Brent",D,02/22/1966,"Vegreville, Alberta",Canada,328,10,30,40,825
"Sevigny, Pierre",F,09/08/1971,"Trois-Rivières, Quebec",Canada,78,4,5,9,64
"Sevigny, Rich",G,04/11/1957,"Montréal, Quebec",Canada,176,0,1,1,84
"Sexton, Ben",F,06/06/1991,"Kanata, Ontario",Canada,2,0,0,0,0
"Sexton, Dan",F,04/29/1987,"Apple Valley, Minnesota",United States,88,13,19,32,20
"Sgarbossa, Michael",F,07/25/1992,"Campbellville, Ontario",Canada,65,4,12,16,23
"Shack, Eddie",F,02/11/1937,"Sudbury, Ontario",Canada,1047,239,226,465,1431
"Shack, Joe",F,12/08/1915,"Winnipeg, Manitoba",Canada,70,9,27,36,20
"Shafranov, Konstantin",F,09/11/1968,Ust-Kamenogorsk,Kazakhstan,5,2,1,3,0
"Shakes, Paul",D,09/04/1952,"Collingwood, Ontario",Canada,21,0,4,4,12
"Shaldybin, Evgeny",D,07/29/1975,Novosibirsk,Russia,3,1,0,1,0
"Shanahan, Brendan",F,01/23/1969,"Mimico, Ontario",Canada,1524,656,698,1354,2489
"Shanahan, Sean",F,02/08/1951,"Toronto, Ontario",Canada,40,1,3,4,47
"Shand, Dave",D,08/11/1956,"Cold Lake, Alberta",Canada,421,19,84,103,544
"Shank, Daniel",F,05/12/1967,"Montréal, Quebec",Canada,77,13,14,27,175
"Shannon, Chuck",D,03/22/1916,"Campbellford, Ontario",Canada,4,0,0,0,2
"Shannon, Darrin",F,12/08/1969,"Barrie, Ontario",Canada,506,87,163,250,344
"Shannon, Darryl",D,06/21/1968,"Barrie, Ontario",Canada,544,28,111,139,523
"Shannon, Gerry",F,10/25/1910,"Campbellford, Ontario",Canada,180,23,29,52,80
"Shannon, Ryan",F,03/02/1983,"Darien, Connecticut",United States,305,35,64,99,90
"Shantz, Jeff",F,10/10/1973,"Duchess, Alberta",Canada,642,72,139,211,341
"Sharangovich, Yegor",F,06/06/1998,Minsk,Belarus,130,40,36,76,27
"Sharifijanov, Vadim",F,12/23/1975,Ufa,Russia,92,16,21,37,50
"Sharp, MacGregor",F,10/01/1985,"Red Deer, Alberta",Canada,8,0,0,0,0
"Sharp, Patrick",F,12/27/1981,"Winnipeg, Manitoba",Canada,939,287,333,620,536
"Sharples, Jeff",D,07/28/1967,"Terrace, British Columbia",Canada,105,14,35,49,70
"Sharples, Warren",G,03/01/1968,"Calgary, Alberta",Canada,1,0,0,0,0
"Sharpley, Glen",F,09/06/1956,"York, Ontario",Canada,389,117,161,278,199
"Shattenkirk, Kevin",D,01/29/1989,"Greenwich, Connecticut",United States,816,93,340,433,470
"Shaunessy, Scott",D,01/22/1964,"Newport, Rhode Island",United States,7,0,0,0,23
"Shaw, Andrew",F,07/20/1991,"Belleville, Ontario",Canada,544,116,131,247,573
"Shaw, Brad",D,04/28/1964,"Cambridge, Ontario",Canada,377,22,137,159,208
"Shaw, David",D,05/25/1964,"St. Thomas, Ontario",Canada,769,41,153,194,906
"Shaw, Logan",F,10/05/1992,"Glace Bay, Nova Scotia",Canada,232,16,23,39,37
"Shaw, Mason",F,11/03/1998,"Lloydminster, Alberta",Canada,3,0,0,0,5
"Shay, Norman",F,02/03/1899,"Huntsville, Ontario",Canada,53,5,4,9,34
"Shea, Pat",D,10/29/1912,"Potlatch, Idaho",United States,10,0,1,1,0
"Sheahan, Riley",F,12/07/1991,"St. Catharines, Ontario",Canada,635,74,120,194,93
"Shearer, Rob",F,10/19/1976,"Kitchener, Ontario",Canada,2,0,0,0,0
"Sheary, Conor",F,08/06/1992,"Melrose, Massachusetts",United States,449,105,110,215,90
"Shedden, Doug",F,04/29/1961,"Wallaceburg, Ontario",Canada,416,139,186,325,176
"Sheehan, Bobby",F,01/11/1949,"Weymouth, Massachusetts",United States,310,48,63,111,50
"Sheehy, Neil",D,02/09/1960,"Fort Frances, Ontario",Canada,379,18,47,65,1316
"Sheehy, Tim",F,09/03/1948,"Fort Frances, Ontario",Canada,27,2,1,3,0
"Shelley, Jody",F,02/07/1976,"Thompson, Manitoba",Canada,627,18,36,54,1538
"Shelton, Doug",F,06/27/1945,"Woodstock, Ontario",Canada,5,0,1,1,2
"Sheppard, Frank",F,10/19/1907,"Montréal, Quebec",Canada,9,1,0,1,0
"Sheppard, Gregg",F,04/23/1949,"North Battleford, Saskatchewan",Canada,657,205,293,498,243
"Sheppard, James",F,04/25/1988,"Halifax, Nova Scotia",Canada,394,23,68,91,192
"Sheppard, Johnny",F,07/23/1903,"Montréal, Quebec",Canada,311,69,58,127,228
"Sheppard, Ray",F,05/27/1966,"Pembroke, Ontario",Canada,817,357,300,657,212
"Sherf, John",F,04/08/1913,"Calumet, Michigan",United States,19,0,0,0,8
"Shero, Fred",D,10/23/1925,"Winnipeg, Manitoba",Canada,145,6,14,20,137
"Sherritt, Gordon",D,04/08/1919,"Oakville, Manitoba",Canada,8,0,0,0,12
"Sherven, Gord",F,08/21/1963,"Mankota, Saskatchewan",Canada,97,13,22,35,33
"Sherwood, Kiefer",F,03/31/1995,"Columbus, Ohio",United States,87,7,11,18,14
"Sherwood, Kole",F,01/22/1997,"New Albany, Ohio",United States,12,0,1,1,9
"Shesterkin, Igor",G,12/30/1995,Moscow,Russia,100,0,1,1,2
"Shevalier, Jeff",F,03/14/1974,"Mississauga, Ontario",Canada,32,5,9,14,8
"Shewchuk, Jack",D,06/19/1917,"Brantford, Ontario",Canada,187,9,19,28,160
"Shibicky, Alex",F,05/19/1914,"Winnipeg, Manitoba",Canada,324,109,92,201,161
"Shields, Al",D,05/10/1907,"Ottawa, Ontario",Canada,459,42,47,89,618
"Shields, Steve",G,07/19/1972,"Toronto, Ontario",Canada,246,0,2,2,78
"Shill, Bill",F,03/06/1923,"Toronto, Ontario",Canada,79,21,13,34,18
"Shill, Jack",D,01/12/1913,"Toronto, Ontario",Canada,160,15,20,35,70
"Shinkaruk, Hunter",F,10/13/1994,"Calgary, Alberta",Canada,15,2,2,4,4
"Shinnimin, Brendan",F,01/07/1991,"East Saint Paul, Manitoba",Canada,12,0,1,1,8
"Shinske, Rick",F,05/31/1955,"Weyburn, Saskatchewan",Canada,63,5,16,21,10
"Shipachev, Vadim",F,03/12/1987,Cherepovets,Russia,3,1,0,1,2
"Shires, Jim",F,11/15/1945,"Edmonton, Alberta",Canada,56,3,6,9,32
"Shirokov, Sergei",F,03/10/1986,Moscow,Russia,8,1,0,1,2
"Shishkanov, Timofei",F,06/10/1983,Moscow,Russia,24,3,2,5,6
"Shmyr, Paul",D,01/28/1946,"Cudworth, Saskatchewan",Canada,343,13,72,85,528
"Shoebottom, Bruce",D,08/20/1965,"Windsor, Ontario",Canada,35,1,4,5,53
"Shore, Devin",F,07/19/1994,"Ajax, Ontario",Canada,375,49,77,126,65
"Shore, Drew",F,01/29/1991,"Denver, Colorado",United States,98,9,17,26,30
"Shore, Eddie",D,11/25/1902,"Fort Qu'Appelle, Saskatchewan",Canada,551,105,179,284,1099
"Shore, Hamby",F,02/12/1886,"Ottawa, Ontario",Canada,18,3,8,11,51
"Shore, Nick",F,09/26/1992,"Denver, Colorado",United States,299,18,41,59,98
"Short, Steve",F,04/06/1954,"Roseville, Minnesota",United States,6,0,0,0,2
"Shtalenkov, Mikhail",G,10/20/1965,Moscow,Russia,190,0,6,6,14
"Shuchuk, Gary",F,02/17/1967,"Edmonton, Alberta",Canada,142,13,26,39,70
"Shudra, Ron",D,11/28/1967,"Winnipeg, Manitoba",Canada,10,0,5,5,6
"Shugg, Justin",F,12/24/1991,"Niagara Falls, Ontario",Canada,3,0,0,0,2
"Shulmistra, Rich",G,04/01/1971,"Sudbury, Ontario",Canada,2,0,0,0,0
"Shutt, Steve",F,07/01/1952,"Toronto, Ontario",Canada,930,424,393,817,410
"Shvidki, Denis",F,11/21/1980,Kharkiv,Ukraine,76,11,14,25,30
"Sidorkiewicz, Peter",G,06/29/1963,Dabrowa Bialostocka,Poland,246,0,9,9,20
"Siebert, Babe",F,01/14/1904,"Plattsville, Ontario",Canada,594,140,154,294,1002
"Siegenthaler, Jonas",D,05/06/1997,Zürich,Switzerland,175,3,24,27,99
"Sieloff, Patrick",D,05/15/1994,"Ann Arbor, Michigan",United States,2,2,0,2,2
"Siemens, Duncan",D,09/07/1993,"Edmonton, Alberta",Canada,20,1,1,2,25
"Sifers, Jaime",D,01/18/1983,"Stratford, Connecticut",United States,37,0,2,2,24
"Sigalet, Jonathan",D,02/12/1986,"Vancouver, British Columbia",Canada,1,0,0,0,4
"Sigalet, Jordan",G,02/19/1981,"New Westminster, British Columbia",Canada,1,0,0,0,0
"Siklenka, Mike",F,12/18/1979,"Meadow Lake, Saskatchewan",Canada,2,0,0,0,0
"Sikura, Dylan",F,06/01/1995,"Aurora, Ontario",Canada,58,3,14,17,0
"Silfverberg, Jakob",F,10/13/1990,Gävle,Sweden,658,151,177,328,208
"Silk, Dave",F,01/01/1958,"Scituate, Massachusetts",United States,249,54,59,113,271
"Sill, Zach",F,05/24/1988,"Truro, Nova Scotia",Canada,93,2,3,5,98
"Sillinger, Cole",F,05/16/2003,"Columbus, Ohio",United States,79,16,15,31,37
"Sillinger, Mike",F,06/29/1971,"Regina, Saskatchewan",Canada,1049,240,308,548,644
"Siltala, Mike",F,08/05/1963,"Toronto, Ontario",Canada,7,1,0,1,2
"Siltanen, Risto",D,10/31/1958,Mänttä,Finland,562,90,265,355,266
"Sim, Jon",F,09/29/1977,"New Glasgow, Nova Scotia",Canada,469,75,64,139,314
"Sim, Trevor",F,06/09/1970,"Calgary, Alberta",Canada,3,0,1,1,2
"Simard, Martin",F,06/25/1966,"Montréal, Quebec",Canada,44,1,5,6,183
"Simek, Radim",D,09/20/1992,Mlada Boleslav,Czech Republic,165,6,20,26,45
"Simicek, Roman",F,11/04/1971,Ostrava,Czech Republic,63,7,10,17,59
"Simmer, Charlie",F,03/20/1954,"Terrace Bay, Ontario",Canada,712,342,369,711,544
"Simmonds, Wayne",F,08/26/1988,"Scarborough, Ontario",Canada,1019,263,261,524,1264
"Simmons, Al",D,09/25/1951,"Winnipeg, Manitoba",Canada,11,0,1,1,21
"Simmons, Don",G,09/13/1931,"Port Colborne, Ontario",Canada,249,0,0,0,14
"Simmons, Gary",G,07/19/1944,"Charlottetown, Prince Edward Island",Canada,107,0,1,1,52
"Simon, Ben",F,06/14/1978,"Shaker Heights, Ohio",United States,81,3,1,4,47
"Simon, Chris",F,01/30/1972,"Wawa, Ontario",Canada,782,144,161,305,1824
"Simon, Cully",D,05/08/1918,"Brockville, Ontario",Canada,130,4,11,15,121
"Simon, Dominik",F,08/08/1994,Prague,Czech Republic,256,22,55,77,80
"Simon, Jason",F,03/21/1969,"Sarnia, Ontario",Canada,5,0,0,0,34
"Simon, Thain",D,04/24/1922,"Brockville, Ontario",Canada,3,0,0,0,0
"Simon, Todd",F,04/21/1972,"Toronto, Ontario",Canada,15,0,1,1,0
"Simonetti, Frank",D,09/11/1962,"Melrose, Massachusetts",United States,115,5,8,13,76
"Simpson, Bobby",F,11/17/1956,"Caughnawaga, Quebec",Canada,175,35,29,64,98
"Simpson, Cliff",F,04/04/1923,"Toronto, Ontario",Canada,6,0,1,1,0
"Simpson, Craig",F,02/15/1967,"London, Ontario",Canada,634,247,250,497,657
"Simpson, Dillon",D,02/10/1993,"Edmonton, Alberta",Canada,3,0,0,0,2
"Simpson, Joe",D,08/13/1893,"Selkirk, Manitoba",Canada,228,21,19,40,172
"Simpson, Kent",G,03/26/1992,"Edmonton, Alberta",Canada,1,0,0,0,0
"Simpson, Reid",F,05/21/1969,"Flin Flon, Manitoba",Canada,301,18,18,36,838
"Simpson, Todd",D,05/28/1973,"North Vancouver, British Columbia",Canada,580,14,63,77,1357
"Sims, Al",D,04/18/1953,"Toronto, Ontario",Canada,476,49,116,165,286
"Sims, Shane",D,04/30/1988,"East Amherst, New York",United States,1,0,0,0,0
"Sinclair, Reg",F,03/06/1925,"Lachine, Quebec",Canada,208,49,43,92,139
"Singbush, Alex",D,01/31/1914,"Winnipeg, Manitoba",Canada,32,0,5,5,15
"Sinisalo, Ilkka",F,07/10/1958,Valkeakoski,Finland,582,204,223,427,208
"Siren, Ville",D,02/11/1964,Tampere,Finland,290,14,68,82,276
"Sirois, Bob",F,02/06/1954,"Montréal, Quebec",Canada,286,92,120,212,42
"Sislo, Mike",F,01/20/1988,"Superior, Wisconsin",United States,42,3,2,5,6
"Sissons, Colton",F,11/05/1993,"North Vancouver, British Columbia",Canada,455,61,74,135,161
"Sittler, Darryl",F,09/18/1950,"Kitchener, Ontario",Canada,1096,484,637,1121,948
"Sivek, Michal",F,01/21/1981,Nachod,Czech Republic,38,3,3,6,14
"Sjöberg, Lars-Erik",D,04/05/1944,Falun,Sweden,79,7,27,34,48
"Sjödin, Tommy",F,08/13/1965,Timrå,Sweden,106,8,40,48,52
"Sjöström, Fredrik",F,05/06/1983,Färgelanda,Sweden,489,46,58,104,190
"Skaare, Bjørne",F,10/29/1958,Oslo,Norway,1,0,0,0,0
"Skalde, Jarrod",F,02/26/1971,"Niagara Falls, Ontario",Canada,115,13,21,34,62
"Skapski, Mackenzie",G,06/15/1994,"Abbotsford, British Columbia",Canada,2,0,0,0,0
"Skarda, Randy",D,05/05/1968,"St. Paul, Minnesota",United States,26,0,5,5,11
"Skidmore, Paul",G,07/22/1956,"Smithtown, New York",United States,2,0,0,0,0
"Skille, Jack",F,05/19/1987,"Madison, Wisconsin",United States,368,43,41,84,118
"Skilton, Raymie",D,09/26/1889,"Cambridge, Massachusetts",United States,1,0,0,0,0
"Skinner, Alf",F,01/26/1896,"Toronto, Ontario",Canada,71,26,12,38,93
"Skinner, Brett",D,06/28/1983,"Brandon, Manitoba",Canada,11,0,0,0,4
"Skinner, Jeff",F,05/16/1992,"Markham, Ontario",Canada,853,298,244,542,378
"Skinner, Larry",F,04/21/1956,"Vancouver, British Columbia",Canada,47,10,12,22,8
"Skinner, Stuart",G,11/01/1998,"Edmonton, Alberta",Canada,14,0,0,0,0
"Skjei, Brady",D,03/26/1994,"Lakeville, Minnesota",United States,448,37,125,162,252
"Skolney, Wade",D,06/24/1981,"Wynyard, Saskatchewan",Canada,1,0,0,0,2
"Skopintsev, Andrei",D,09/28/1971,Moscow,Russia,40,2,4,6,32
"Skorodenski, Warren",G,03/22/1960,"Winnipeg, Manitoba",Canada,35,0,0,0,2
"Skoula, Martin",D,10/28/1979,Litomerice,Czech Republic,776,44,152,196,328
"Skov, Glen",F,01/26/1931,"Wheatley, Ontario",Canada,650,106,136,242,411
"Skrastins, Karlis",D,07/09/1974,Riga,Latvia,832,32,104,136,375
"Skrbek, Pavel",D,08/08/1978,Kladno,Czech Republic,12,0,0,0,8
"Skriko, Petri",F,03/12/1962,Lappeenranta,Finland,541,183,222,405,246
"Skrlac, Rob",F,06/10/1976,"Port McNeill, British Columbia",Canada,8,1,0,1,22
"Skrudland, Brian",F,07/31/1963,"Peace River, Alberta",Canada,881,124,219,343,1107
"Skudra, Peter",G,04/24/1973,Riga,Latvia,146,0,2,2,6
"Slaney, John",D,02/07/1972,"St. John's, Newfoundland and Labrador",Canada,268,22,69,91,99
"Slater, Jim",F,12/09/1982,"Petoskey, Michigan",United States,584,67,71,138,407
"Slavin, Jaccob",D,05/01/1994,"Erie, Colorado",United States,508,36,172,208,70
"Slavin, Josiah",F,12/31/1998,"Erie, Colorado",United States,15,0,1,1,4
"Sleaver, John",F,08/18/1934,"Copper Cliff, Ontario",Canada,13,1,0,1,4
"Slegr, Jiri",D,05/30/1971,Jihlava,Czech Republic,622,56,193,249,838
"Sleigher, Louis",F,10/23/1958,"Nouvelle, Quebec",Canada,194,46,53,99,146
"Slepyshev, Anton",F,05/13/1994,Penza,Russia,102,10,13,23,14
"Sloan, Blake",F,07/27/1975,"Park Ridge, Illinois",United States,290,11,32,43,162
"Sloan, Tod",F,11/30/1927,"Pontiac, Quebec",Canada,744,220,262,482,842
"Sloan, Tyler",D,03/15/1981,"Calgary, Alberta",Canada,99,4,13,17,50
"Sloane, David",F,04/06/1985,"Ambler, Pennsylvania",United States,1,0,0,0,0
"Slobodian, Peter",D,04/24/1918,"Dauphin, Manitoba",Canada,41,3,2,5,56
"Slowinski, Eddie",F,11/18/1922,"Winnipeg, Manitoba",Canada,291,58,74,132,63
"Sly, Darryl",D,04/03/1939,"Collingwood, Ontario",Canada,79,1,2,3,20
"Smaby, Matt",D,10/14/1984,"Minneapolis, Minnesota",United States,122,0,6,6,106
"Smail, Doug",F,09/02/1957,"Moose Jaw, Saskatchewan",Canada,845,210,249,459,602
"Smart, Alex",F,05/29/1918,"Brandon, Manitoba",Canada,8,5,2,7,0
"Smedsmo, Dale",F,04/23/1951,"Roseau, Minnesota",United States,4,0,0,0,0
"Smehlik, Richard",D,01/23/1970,Ostrava,Czech Republic,644,49,146,195,415
"Smid, Ladislav",D,02/01/1986,Frydlant v Cechach,Czech Republic,583,12,60,72,472
"Smillie, Don",F,09/13/1910,"Toronto, Ontario",Canada,12,2,2,4,4
"Smirnov, Alexei",F,01/28/1982,Tver,Russia,52,3,3,6,20
"Smith, Al",G,11/10/1945,"Toronto, Ontario",Canada,231,0,7,7,122
"Smith, Alex",D,04/02/1902,"Liverpool, England",United Kingdom,443,41,51,92,645
"Smith, Arthur",F,11/29/1906,"Toronto, Ontario",Canada,144,15,10,25,253
"Smith, Barry",F,04/25/1955,"Surrey, British Columbia",Canada,114,7,7,14,10
"Smith, Ben",F,07/11/1988,"Winston-Salem, North Carolina",United States,237,29,25,54,8
"Smith, Billy",G,12/12/1950,"Perth, Ontario",Canada,679,1,12,13,475
"Smith, Bobby",F,02/12/1958,"North Sydney, Nova Scotia",Canada,1077,357,679,1036,919
"Smith, Brad",F,04/13/1958,"Windsor, Ontario",Canada,222,28,34,62,593
"Smith, Brandon",D,02/25/1973,"Hazelton, British Columbia",Canada,33,3,4,7,10
"Smith, Brendan",D,02/08/1989,"Toronto, Ontario",Canada,571,33,85,118,630
"Smith, Brian",F,09/06/1940,"Ottawa, Ontario",Canada,67,10,10,20,33
"Smith, Brian",F,12/06/1937,"Creighton Mine, Ontario",Canada,61,2,8,10,12
"Smith, C.J.",F,12/01/1994,"Des Moines, Iowa",United States,15,2,1,3,0
"Smith, Carl",F,09/18/1917,"Cache Bay, Ontario",Canada,7,1,1,2,2
"Smith, Clint",F,12/12/1913,"Assiniboia, Saskatchewan",Canada,483,161,237,398,24
"Smith, Cole",F,10/28/1995,"Brainerd, Minnesota",United States,9,0,0,0,0
"Smith, Colin",F,06/20/1993,"Edmonton, Alberta",Canada,1,0,0,0,0
"Smith, Craig",F,09/05/1989,"Madison, Wisconsin",United States,789,191,207,398,310
"Smith, D.J.",D,05/13/1977,"Windsor, Ontario",Canada,45,1,1,2,67
"Smith, Dallas",D,10/10/1941,"Hamiota, Manitoba",Canada,889,55,252,307,955
"Smith, Dalton",F,06/30/1992,"Oshawa, Ontario",Canada,1,0,0,0,2
"Smith, Dan",D,10/19/1976,"Fernie, British Columbia",Canada,22,0,0,0,16
"Smith, Dennis",D,07/27/1964,"Detroit, Michigan",United States,8,0,0,0,4
"Smith, Derek",D,10/13/1984,"Belleville, Ontario",Canada,94,2,12,14,24
"Smith, Derek",F,07/31/1954,"Québec City, Quebec",Canada,335,78,116,194,60
"Smith, Derrick",F,01/22/1965,"Scarborough, Ontario",Canada,537,82,92,174,373
"Smith, Des",D,02/22/1914,"Ottawa, Ontario",Canada,195,22,26,48,246
"Smith, Don",F,06/04/1887,"Cornwall, Ontario",Canada,12,1,0,1,6
"Smith, Don",F,05/04/1929,"Regina, Saskatchewan",Canada,10,1,1,2,0
"Smith, Doug",F,05/17/1963,"Ottawa, Ontario",Canada,535,115,138,253,624
"Smith, Floyd",F,05/16/1935,"Perth, Ontario",Canada,617,129,178,307,201
"Smith, Gary",G,02/04/1944,"Ottawa, Ontario",Canada,531,0,7,7,179
"Smith, Gemel",F,04/16/1994,"Toronto, Ontario",Canada,91,12,13,25,58
"Smith, Geoff",D,03/07/1969,"Edmonton, Alberta",Canada,462,18,73,91,282
"Smith, Givani",F,02/27/1998,"Thornhill, Ontario",Canada,83,7,7,14,138
"Smith, Glen",F,03/19/1931,"Lucky Lake, Saskatchewan",Canada,2,0,0,0,0
"Smith, Glenn",D,04/25/1895,"Meaford, Ontario",Canada,9,0,0,0,0
"Smith, Gord",D,11/17/1949,"Perth, Ontario",Canada,299,9,30,39,284
"Smith, Greg",D,07/08/1955,"Ponoka, Alberta",Canada,829,56,232,288,1110
"Smith, Hooley",F,01/07/1903,"Toronto, Ontario",Canada,717,200,226,426,1062
"Smith, Jason",D,11/02/1973,"Calgary, Alberta",Canada,1008,41,128,169,1099
"Smith, Jeremy",G,04/13/1989,"Dearborn, Michigan",United States,10,0,0,0,0
"Smith, Kenny",F,05/08/1924,"Moose Jaw, Saskatchewan",Canada,331,78,93,171,49
"Smith, Mark",F,10/24/1977,"Edmonton, Alberta",Canada,377,23,47,70,457
"Smith, Mike",G,03/22/1982,"Kingston, Ontario",Canada,670,1,20,21,152
"Smith, Nakina",F,07/26/1915,"Cache Bay, Ontario",Canada,10,1,2,3,0
"Smith, Nathan",F,02/09/1982,"Edmonton, Alberta",Canada,26,0,0,0,14
"Smith, Nathan",F,10/19/1998,"Tampa, Florida",United States,10,2,2,4,2
"Smith, Nick",F,03/23/1979,"Hamilton, Ontario",Canada,15,0,0,0,0
"Smith, Norm",G,03/18/1908,"Toronto, Ontario",Canada,198,0,0,0,0
"Smith, Randy",F,07/07/1965,"Saskatoon, Saskatchewan",Canada,3,0,0,0,0
"Smith, Reilly",F,04/01/1991,"Toronto, Ontario",Canada,686,174,243,417,176
"Smith, Rick",D,06/29/1948,"Kingston, Ontario",Canada,687,52,167,219,558
"Smith, Rodger",D,07/26/1896,"Ottawa, Ontario",Canada,210,20,4,24,180
"Smith, Ron",D,11/19/1952,"Port Hope, Ontario",Canada,11,1,1,2,14
"Smith, Sid",F,07/11/1925,"Toronto, Ontario",Canada,601,186,183,369,90
"Smith, Stan",F,08/13/1917,"Coal Creek, British Columbia",Canada,9,2,1,3,0
"Smith, Steve",D,04/30/1963,"Glasgow, Scotland",United Kingdom,804,72,303,375,2139
"Smith, Steve",D,04/04/1963,"Trenton, Ontario",Canada,17,0,1,1,15
"Smith, Stu",F,09/25/1918,"Basswood, Manitoba",Canada,4,2,2,4,0
"Smith, Stu",D,03/17/1960,"Toronto, Ontario",Canada,77,2,10,12,95
"Smith, Tommy",F,09/27/1885,"Ottawa, Ontario",Canada,10,0,1,1,11
"Smith, Trevor",F,02/08/1985,"North Vancouver, British Columbia",Canada,107,9,11,20,20
"Smith, Ty",D,03/24/2000,"Lloydminster, Alberta",Canada,114,7,36,43,44
"Smith, Vern",D,05/30/1964,"Winnipeg, Manitoba",Canada,1,0,0,0,0
"Smith, Wayne",D,02/12/1943,"Kamsack, Saskatchewan",Canada,2,1,1,2,2
"Smith, Wyatt",F,02/13/1977,"Thief River Falls, Minnesota",United States,211,10,22,32,65
"Smith, Zack",F,04/05/1988,"Maple Creek, Saskatchewan",Canada,662,98,106,204,722
"Smith-Pelly, Devante",F,06/14/1992,"Scarborough, Ontario",Canada,395,44,57,101,137
"Smithson, Jerred",F,02/04/1979,"Vernon, British Columbia",Canada,606,39,57,96,363
"Smolenak, Radek",F,12/03/1986,Prague,Czech Republic,7,0,1,1,15
"Smolinski, Bryan",F,12/27/1971,"Toledo, Ohio",United States,1056,274,377,651,606
"Smrek, Peter",D,02/16/1979,Martin,Slovakia,28,2,4,6,18
"Smrke, John",F,02/25/1956,"Chicoutimi, Quebec",Canada,103,11,17,28,33
"Smrke, Stan",F,09/02/1928,Belgrade,Serbia,9,0,3,3,0
"Smyl, Stan",F,01/28/1958,"Glendon, Alberta",Canada,896,262,411,673,1556
"Smylie, Rod",F,09/28/1895,"Toronto, Ontario",Canada,74,3,2,5,12
"Smyth, Brad",F,03/13/1973,"Ottawa, Ontario",Canada,88,15,13,28,109
"Smyth, Greg",D,04/23/1966,"Oakville, Ontario",Canada,229,4,16,20,783
"Smyth, Kevin",F,11/22/1973,"Banff, Alberta",Canada,58,6,8,14,31
"Smyth, Ryan",F,02/21/1976,"Banff, Alberta",Canada,1270,386,456,842,976
"Sneddon, Bob",G,05/31/1944,"Montréal, Quebec",Canada,7,0,0,0,0
"Sneep, Carl",D,11/05/1987,"St. Louis Park, Minnesota",United States,1,0,1,1,0
"Snell, Chris",D,05/12/1971,"Regina, Saskatchewan",Canada,34,2,7,9,24
"Snell, Ron",F,08/11/1948,"Regina, Saskatchewan",Canada,7,3,2,5,6
"Snell, Ted",F,05/28/1946,"Ottawa, Ontario",Canada,104,7,18,25,22
"Snepsts, Harold",D,10/24/1954,"Edmonton, Alberta",Canada,1033,38,195,233,2009
"Snively, Joseph",F,01/01/1996,"Herndon, Virginia",United States,12,4,3,7,2
"Snow, Garth",G,07/28/1969,"Wrentham, Massachusetts",United States,368,0,5,5,190
"Snow, Sandy",F,11/11/1946,"Glace Bay, Nova Scotia",Canada,3,0,0,0,2
"Snuggerud, Dave",F,06/20/1966,"Minnetonka, Minnesota",United States,265,30,54,84,127
"Snyder, Dan",F,02/23/1978,"Elmira, Ontario",Canada,49,11,5,16,64
"Sobchuk, Dennis",F,01/12/1954,"Lang, Saskatchewan",Canada,35,5,6,11,2
"Sobchuk, Gene",F,02/19/1951,"Lang, Saskatchewan",Canada,1,0,0,0,0
"Sobotka, Vladimir",F,07/02/1987,Trebic,Czech Republic,548,53,118,171,362
"Söderberg, Carl",F,10/12/1985,Malmö,Sweden,597,110,187,297,210
"Söderblom, Arvid",G,08/19/1999,Göteborg,Sweden,3,0,0,0,0
"Söderström, Tommy",G,07/17/1969,Stockholm,Sweden,156,0,2,2,13
"Söderström, Victor",D,02/26/2001,Skutskär,Sweden,20,1,1,2,6
"Soetaert, Doug",G,04/21/1955,"Edmonton, Alberta",Canada,284,0,7,7,68
"Sokolov, Yegor",F,06/07/2000,Yekaterinburg,Russia,8,0,0,0,4
"Solheim, Ken",F,03/27/1961,"Hythe, Alberta",Canada,135,19,20,39,34
"Solinger, Bob",F,12/23/1925,"Star City, Saskatchewan",Canada,99,10,11,21,19
"Somers, Art",F,01/19/1902,"Winnipeg, Manitoba",Canada,222,33,56,89,195
"Somík, Radovan",F,05/05/1977,Martin,Slovakia,113,12,20,32,27
"Sommer, Roy",F,04/05/1957,"Oakland, California",United States,3,1,0,1,7
"Songin, Tom",F,12/20/1953,"Norwood, Massachusetts",United States,43,5,5,10,22
"Sonmor, Glen",F,04/22/1929,"Moose Jaw, Saskatchewan",Canada,28,2,0,2,21
"Sonnenberg, Martin",F,01/23/1978,"Wetaskiwin, Alberta",Canada,63,2,3,5,21
"Sopel, Brent",D,01/07/1977,"Calgary, Alberta",Canada,659,44,174,218,309
"Sörensen, Marcus",F,04/07/1992,Södertälje,Sweden,226,31,33,64,74
"Sörensen, Nick",F,10/23/1994,Holbaek,Denmark,5,0,1,1,2
"Sorochan, Lee",D,09/09/1975,"Edmonton, Alberta",Canada,3,0,0,0,0
"Sorokin, Ilya",G,08/04/1995,Mezhdurechensk,Russia,74,0,0,0,0
"Sorrell, John",F,01/16/1906,"Chesterville, Ontario",Canada,490,127,120,247,100
"Soshnikov, Nikita",F,10/14/1993,Nizhny Tagil,Russia,87,8,8,16,26
"Soucy, Carson",D,07/24/1994,"Viking, Alberta",Canada,172,18,34,52,118
"Soucy, Christian",G,09/14/1970,"Gatineau, Quebec",Canada,1,0,0,0,0
"Souray, Sheldon",D,07/13/1976,"Elk Point, Alberta",Canada,758,109,191,300,1145
"Spacek, Jaroslav",D,02/11/1974,Rokycany,Czech Republic,880,82,273,355,618
"Spaling, Nick",F,09/19/1988,"Palmerston, Ontario",Canada,437,52,72,124,120
"Spanhel, Martin",F,07/01/1977,Zlin,Czech Republic,10,2,0,2,4
"Sparks, Garret",G,06/28/1993,"Elmhurst, Illinois",United States,40,0,0,0,0
"Sparrow, Emory",F,09/15/1898,"Hartney, Manitoba",Canada,8,0,0,0,4
"Speck, Fred",F,07/22/1947,"Thorold, Ontario",Canada,28,1,2,3,2
"Speer, Bill",D,03/20/1942,"Lindsay, Ontario",Canada,130,5,20,25,79
"Speers, Blake",F,01/02/1997,"Sault Ste. Marie, Ontario",Canada,5,0,0,0,2
"Speers, Ted",F,01/28/1961,"Ann Arbor, Michigan",United States,4,1,1,2,0
"Spence, Gordon",F,07/25/1897,"Haileybury, Ontario",Canada,3,0,0,0,0
"Spence, Jordan",D,02/24/2001,"Cornwall, Prince Edward Island",Canada,24,2,6,8,2
"Spencer, Brian",F,09/03/1949,"Fort St. James, British Columbia",Canada,553,80,143,223,634
"Spencer, Irv",D,12/04/1937,"Sudbury, Ontario",Canada,230,12,38,50,127
"Speyer, Chris",D,02/06/1907,"Toronto, Ontario",Canada,14,0,0,0,0
"Spezza, Jason",F,06/13/1983,"Mississauga, Ontario",Canada,1248,363,632,995,604
"Spiller, Matthew",D,02/07/1983,"Daysland, Alberta",Canada,68,0,2,2,74
"Spooner, Red",G,08/24/1910,"Thunder Bay, Ontario",Canada,1,0,0,0,0
"Spooner, Ryan",F,01/30/1992,"Kanata, Ontario",Canada,325,48,119,167,63
"Spring, Corey",F,05/31/1971,"Cranbrook, British Columbia",Canada,16,1,1,2,12
"Spring, Don",D,06/15/1959,Maracaibo,Venezuela,259,1,54,55,80
"Spring, Frank",F,10/19/1949,"Rossland, British Columbia",Canada,61,14,20,34,12
"Spring, Jesse",D,01/18/1901,"Alba, Pennsylvania",United States,133,11,4,15,78
"Sprong, Daniel",F,03/17/1997,Amsterdam,Netherlands,202,46,24,70,30
"Sproul, Ryan",D,01/13/1993,"Mississauga, Ontario",Canada,44,2,10,12,12
"Spruce, Andy",F,04/17/1954,"London, Ontario",Canada,172,31,42,73,111
"Sprukts, Janis",F,01/31/1982,Riga,Latvia,14,1,2,3,2
"Spurgeon, Jared",D,11/29/1989,"Edmonton, Alberta",Canada,772,99,246,345,130
"Srsen, Tomas",F,08/25/1966,Olomouc,Czech Republic,2,0,0,0,0
"St. Amour, Martin",F,01/30/1970,"Montréal, Quebec",Canada,1,0,0,0,2
"St. Croix, Rick",G,01/03/1955,"Kenora, Ontario",Canada,131,0,2,2,2
"St. Denis, Frederic",D,01/23/1986,"Greenfield Park, Quebec",Canada,21,1,3,4,10
"St. Jacques, Bruno",D,08/22/1980,"Montréal, Quebec",Canada,67,3,7,10,47
"St. Laurent, Andre",F,02/16/1953,"Rouyn-Noranda, Quebec",Canada,644,129,187,316,749
"St. Laurent, Dollard",D,05/12/1929,"Verdun, Quebec",Canada,652,29,133,162,500
"St. Laurent, Sam",G,02/16/1959,"Arvida, Quebec",Canada,34,0,0,0,4
"St. Louis, Martin",F,06/18/1975,"Laval, Quebec",Canada,1134,391,642,1033,310
"St. Marseille, Frank",F,12/14/1939,"Levack, Ontario",Canada,707,140,285,425,244
"St. Pierre, Martin",F,08/11/1983,"Ottawa, Ontario",Canada,39,3,5,8,12
"St. Sauveur, Claude",F,01/02/1952,"Sherbrooke, Quebec",Canada,79,24,24,48,23
"Staal, Eric",F,10/29/1984,"Thunder Bay, Ontario",Canada,1293,441,593,1034,828
"Staal, Jared",F,08/21/1990,"Thunder Bay, Ontario",Canada,2,0,0,0,2
"Staal, Jordan",F,09/10/1988,"Thunder Bay, Ontario",Canada,1092,258,353,611,523
"Staal, Marc",D,01/13/1987,"Thunder Bay, Ontario",Canada,1019,49,165,214,480
"Stackhouse, Ron",D,08/26/1949,"Haliburton, Ontario",Canada,889,87,372,459,824
"Stackhouse, Ted",D,11/02/1894,"Wolfville, Nova Scotia",Canada,13,0,0,0,2
"Stafford, Drew",F,10/30/1985,"Milwaukee, Wisconsin",United States,841,196,232,428,415
"Stafford, Garrett",D,01/28/1980,"Los Angeles, California",United States,7,0,2,2,0
"Staios, Steve",F,07/28/1973,"Hamilton, Ontario",Canada,1001,56,164,220,1322
"Stajan, Matthew",F,12/19/1983,"Mississauga, Ontario",Canada,1003,146,267,413,526
"Stajduhar, Nick",D,12/06/1974,"Kitchener, Ontario",Canada,2,0,0,0,4
"Stålberg, Viktor",F,01/17/1986,Stockholm,Sweden,488,82,86,168,245
"Staley, Alan 'Red'",F,09/21/1928,"Regina, Saskatchewan",Canada,1,0,1,1,0
"Stalock, Alex",G,07/28/1987,"St. Paul, Minnesota",United States,152,0,4,4,12
"Stamkos, Steven",F,02/07/1990,"Markham, Ontario",Canada,922,481,491,972,551
"Stamler, Lorne",F,08/09/1951,"Winnipeg, Manitoba",Canada,116,14,11,25,16
"Stana, Rastislav",G,01/10/1980,Kosice,Slovakia,6,0,0,0,0
"Standing, George",F,08/03/1941,"Toronto, Ontario",Canada,2,0,0,0,0
"Stanfield, Fred",F,05/04/1944,"Toronto, Ontario",Canada,914,211,405,616,134
"Stanfield, Jim",F,01/01/1947,"Toronto, Ontario",Canada,7,0,1,1,0
"Staniowski, Ed",G,07/07/1955,"Moose Jaw, Saskatchewan",Canada,219,0,10,10,10
"Stankiewicz, Edward",F,12/01/1929,"Kitchener, Ontario",Canada,6,0,0,0,2
"Stankiewicz, Myron",F,12/04/1935,"Kitchener, Ontario",Canada,35,0,7,7,36
"Stanley, Allan",D,03/01/1926,"Timmins, Ontario",Canada,1244,100,333,433,792
"Stanley, Barney",F,01/01/1893,"Paisley, Ontario",Canada,1,0,0,0,0
"Stanley, Daryl",F,12/02/1962,"Winnipeg, Manitoba",Canada,189,8,17,25,408
"Stanley, Logan",D,05/26/1998,"Kitchener, Ontario",Canada,95,2,15,17,70
"Stanowski, Wally",D,04/28/1919,"Winnipeg, Manitoba",Canada,428,23,88,111,160
"Stanton, Paul",D,06/22/1967,"Boston, Massachusetts",United States,295,14,49,63,262
"Stanton, Ryan",D,07/20/1989,"St. Albert, Alberta",Canada,120,4,23,27,71
"Stapleton, Brian",D,12/25/1951,"Fort Erie, Ontario",Canada,1,0,0,0,0
"Stapleton, Mike",F,05/05/1966,"Sarnia, Ontario",Canada,697,71,111,182,342
"Stapleton, Pat",D,07/04/1940,"Sarnia, Ontario",Canada,635,43,294,337,351
"Stapleton, Tim",F,07/19/1982,"La Grange, Illinois",United States,118,19,18,37,24
"Starikov, Sergei",D,12/04/1958,Chelyabinsk,Russia,16,0,1,1,8
"Starr, Harold",D,07/06/1906,"Ottawa, Ontario",Canada,206,5,4,9,189
"Starr, Wilf",F,07/22/1909,"St. Boniface, Manitoba",Canada,87,9,7,16,25
"Stasiuk, Vic",F,05/23/1929,"Lethbridge, Alberta",Canada,745,183,254,437,665
"Stastny, Anton",F,08/05/1959,Bratislava,Slovakia,650,252,384,636,150
"Stastny, Marian",F,01/08/1953,Bratislava,Slovakia,322,121,173,294,110
"Stastny, Paul",F,12/27/1985,"Québec City, Quebec",Canada,1072,284,516,800,484
"Stastny, Peter",F,09/18/1956,Bratislava,Slovakia,977,450,789,1239,824
"Stastny, Yan",F,09/30/1982,"Québec City, Quebec",Canada,91,6,10,16,58
"Staszak, Ray",F,12/01/1962,"Philadelphia, Pennsylvania",United States,4,0,1,1,7
"Stauber, Robb",G,11/25/1967,"Duluth, Minnesota",United States,62,0,2,2,22
"Staubitz, Brad",F,07/28/1984,"Edmonton, Alberta",Canada,230,10,11,21,521
"Stecher, Troy",D,04/07/1994,"Richmond, British Columbia",Canada,359,15,74,89,149
"Steckel, Dave",F,03/15/1982,"Westbend, Wisconsin",United States,425,33,46,79,129
"Steel, Sam",F,02/03/1998,"Ardrossan, Alberta",Canada,197,24,41,65,52
"Steele, Frank",D,03/19/1905,"Niagara Falls, Ontario",Canada,1,0,0,0,2
"Steen, Alexander",F,03/01/1984,"Winnipeg, Manitoba",Canada,1018,245,377,622,454
"Steen, Anders",F,04/28/1955,Nyköping,Sweden,42,5,11,16,22
"Steen, Oskar",F,03/09/1998,Karlstad,Sweden,23,2,4,6,8
"Steen, Tom",F,06/08/1960,Grums,Sweden,950,264,553,817,753
"Steeves, Alexander",F,12/10/1999,"Bedford, New Hampshire",United States,3,0,1,1,0
"Stefan, Greg",G,02/11/1961,"Brantford, Ontario",Canada,299,0,15,15,199
"Stefan, Patrik",F,09/16/1980,Pribram,Czech Republic,455,64,124,188,158
"Stefaniw, Morris",F,01/10/1948,"North Battleford, Saskatchewan",Canada,13,1,1,2,2
"Stefanski, Bud",F,04/28/1955,"Timmins, Ontario",Canada,1,0,0,0,0
"Stein, Phil",G,09/13/1913,"Toronto, Ontario",Canada,1,0,0,0,0
"Stemkowski, Pete",F,08/25/1943,"Winnipeg, Manitoba",Canada,967,206,349,555,864
"Stempniak, Lee",F,02/04/1983,"West Seneca, New York",United States,911,203,266,469,327
"Stenlund, Kevin",F,09/20/1996,Stockholm,Sweden,71,11,9,20,22
"Stenlund, Vern",F,04/11/1956,"Thunder Bay, Ontario",Canada,4,0,0,0,0
"Stepan, Derek",F,06/18/1990,"Hastings, Minnesota",United States,817,177,327,504,208
"Stephan, Tobias",G,01/21/1984,Zürich,Switzerland,11,0,1,1,0
"Stephens, Charlie",F,04/05/1981,"London, Ontario",Canada,8,0,2,2,4
"Stephens, Mitchell",F,02/05/1997,"Peterborough, Ontario",Canada,72,3,10,13,18
"Stephenson, Bob",D,02/01/1954,"Saskatoon, Saskatchewan",Canada,18,2,3,5,4
"Stephenson, Chandler",F,04/22/1994,"Saskatoon, Saskatchewan",Canada,339,57,97,154,81
"Stephenson, Shay",F,09/13/1983,"Outlook, Saskatchewan",Canada,2,0,0,0,0
"Stephenson, Wayne",G,01/29/1945,"Thunder Bay, Ontario",Canada,328,0,3,3,43
"Sterling, Brett",F,04/24/1984,"Los Angeles, California",United States,30,5,4,9,32
"Stern, Ronnie",F,01/11/1967,"Sainte-Agathe-de-Lotbiniere, Quebec",Canada,638,75,86,161,2077
"Sterner, Ulf",F,02/11/1941,Deje,Sweden,4,0,0,0,0
"Stevens, John",D,05/04/1966,"Campbellton, New Brunswick",Canada,53,0,10,10,48
"Stevens, Kevin",F,04/15/1965,"Brockton, Massachusetts",United States,874,329,397,726,1470
"Stevens, Mike",F,12/30/1965,"Kitchener, Ontario",Canada,23,1,4,5,29
"Stevens, Phil",D,02/15/1893,"Saint-Lambert, Ontario",Canada,25,1,0,1,3
"Stevens, Scott",D,04/01/1964,"Kitchener, Ontario",Canada,1635,196,712,908,2785
"Stevenson, Doug",G,04/06/1924,"Regina, Saskatchewan",Canada,8,0,0,0,0
"Stevenson, Grant",F,10/15/1981,"Spruce Grove, Alberta",Canada,47,10,12,22,14
"Stevenson, Jeremy",F,07/28/1974,"San Bernardino, California",United States,207,19,19,38,451
"Stevenson, Shayne",F,10/26/1970,"Aurora, Ontario",Canada,27,0,2,2,35
"Stevenson, Turner",F,05/18/1972,"Prince George, British Columbia",Canada,644,75,115,190,969
"Stewart, Alan",F,01/31/1964,"Fort St. John, British Columbia",Canada,64,6,4,10,243
"Stewart, Anthony",F,01/05/1985,"LaSalle, Quebec",Canada,262,27,44,71,123
"Stewart, Bill",D,10/06/1957,"Toronto, Ontario",Canada,261,7,64,71,424
"Stewart, Blair",F,03/15/1953,"Winnipeg, Manitoba",Canada,229,34,44,78,326
"Stewart, Bob",D,11/10/1950,"Charlottetown, Prince Edward Island",Canada,575,27,101,128,809
"Stewart, Cameron",F,09/18/1971,"Kitchener, Ontario",Canada,202,16,23,39,120
"Stewart, Charles",G,11/13/1895,"Carleton Place, Ontario",Canada,77,0,0,0,0
"Stewart, Chris",F,10/30/1987,"Toronto, Ontario",Canada,668,160,162,322,750
"Stewart, Gaye",F,06/23/1923,"Thunder Bay, Ontario",Canada,502,185,159,344,292
"Stewart, Gregory",F,05/21/1986,"Kitchener, Ontario",Canada,26,0,1,1,48
"Stewart, Jack",D,05/06/1917,"Pilot Mound, Manitoba",Canada,565,31,83,114,765
"Stewart, Jim",G,04/23/1957,"Cambridge, Massachusetts",United States,1,0,0,0,0
"Stewart, John",F,05/16/1950,"Eriksdale, Manitoba",Canada,258,58,60,118,158
"Stewart, John",F,01/02/1954,"Toronto, Ontario",Canada,2,0,0,0,0
"Stewart, Karl",F,06/30/1983,"Aurora, Ontario",Canada,69,2,4,6,68
"Stewart, Ken",D,03/29/1913,"Thunder Bay, Ontario",Canada,6,1,1,2,0
"Stewart, Nels",F,12/29/1902,"Montréal, Quebec",Canada,650,324,191,515,955
"Stewart, Paul",F,03/21/1955,"Boston, Massachusetts",United States,21,2,0,2,74
"Stewart, Ralph",F,12/02/1948,"Thunder Bay, Ontario",Canada,252,57,73,130,28
"Stewart, Ron",F,07/11/1932,"Calgary, Alberta",Canada,1353,276,253,529,564
"Stewart, Ryan",F,06/01/1967,"Kelowna, British Columbia",Canada,3,1,0,1,0
"Stienburg, Trevor",F,05/13/1966,"Kingston, Ontario",Canada,71,8,4,12,166
"Stiles, Tony",D,08/12/1959,"Carstairs, Alberta",Canada,30,2,7,9,20
"Stillman, Cory",F,12/20/1973,"Peterborough, Ontario",Canada,1025,278,449,727,489
"Stillman, Riley",D,03/09/1998,"Peterborough, Ontario",Canada,108,3,15,18,68
"Stoa, Ryan",F,04/13/1987,"Bloomington, Minnesota",United States,40,4,3,7,20
"Stock, P.J.",F,05/26/1975,"Montréal, Quebec",Canada,235,5,21,26,523
"Stoddard, Jack",F,09/26/1926,"Stoney Creek, Ontario",Canada,80,16,15,31,31
"Stojanov, Alek",F,04/25/1973,"Windsor, Ontario",Canada,107,2,5,7,222
"Stolarz, Anthony",G,01/20/1994,"Jackson, New Jersey",United States,62,0,2,2,2
"Stoll, Jarret",F,06/24/1982,"Melville, Saskatchewan",Canada,872,144,244,388,618
"Stollery, Karl",D,11/21/1987,"Camrose, Alberta",Canada,23,0,3,3,21
"Stoltz, Roland",F,08/15/1954,Överkalix,Sweden,14,2,2,4,14
"Stone, Mark",F,05/13/1992,"Winnipeg, Manitoba",Canada,541,179,297,476,183
"Stone, Michael",D,07/07/1990,"Winnipeg, Manitoba",Canada,504,35,99,134,274
"Stone, Ryan",F,03/20/1985,"Calgary, Alberta",Canada,35,0,7,7,55
"Stone, Steve",F,09/26/1952,"Toronto, Ontario",Canada,2,0,0,0,0
"Stoner, Clayton",D,02/19/1985,"Port McNeill, British Columbia",Canada,360,7,41,48,459
"Storm, Jim",F,02/05/1971,"Milford, Michigan",United States,84,7,15,22,44
"Storr, Jamie",G,12/28/1975,"Brampton, Ontario",Canada,219,0,3,3,26
"Stortini, Zack",F,09/11/1985,"Elliot Lake, Ontario",Canada,257,14,27,41,725
"Stothers, Michael",D,02/22/1962,"Toronto, Ontario",Canada,30,0,2,2,65
"Stoughton, Blaine",F,03/13/1953,"Gilbert Plains, Manitoba",Canada,526,258,191,449,204
"Stoyanovich, Steve",F,05/02/1957,"London, Ontario",Canada,23,3,5,8,11
"Strachan, Tyson",D,10/30/1984,"Melfort, Saskatchewan",Canada,186,1,19,20,199
"Strain, Neil",F,02/24/1926,"Kenora, Ontario",Canada,52,11,13,24,12
"Strait, Brian",D,01/04/1988,"Boston, Massachusetts",United States,187,6,23,29,91
"Straka, Martin",F,09/03/1972,Plzen,Czech Republic,954,257,460,717,360
"Straka, Petr",F,06/15/1992,Plzen,Czech Republic,3,0,2,2,0
"Strålman, Anton",D,08/01/1986,Tibro,Sweden,930,63,230,293,285
"Strand, Austin",D,02/17/1997,"Calgary, Alberta",Canada,21,0,3,3,8
"Strate, Gord",D,05/28/1935,"Edmonton, Alberta",Canada,62,0,0,0,34
"Stratton, Art",F,10/08/1935,"Winnipeg, Manitoba",Canada,95,18,33,51,24
"Strbak, Martin",D,01/15/1975,Prešov,Slovakia,49,5,11,16,46
"Street, Ben",F,02/13/1987,"Coquitlam, British Columbia",Canada,59,3,6,9,10
"Streit, Mark",D,12/11/1977,Englisberg,Switzerland,786,96,338,434,374
"Strobel, Art",F,11/28/1922,"Regina, Saskatchewan",Canada,7,0,0,0,0
"Strome, Dylan",F,03/07/1997,"Mississauga, Ontario",Canada,273,67,103,170,86
"Strome, Ryan",F,07/11/1993,"Mississauga, Ontario",Canada,621,130,227,357,376
"Strong, Ken",F,05/09/1963,"Toronto, Ontario",Canada,15,2,2,4,6
"Stroshein, Garret",F,04/04/1980,"Edmonton, Alberta",Canada,3,0,0,0,14
"Struch, David",F,02/11/1971,"Flin Flon, Manitoba",Canada,4,0,0,0,4
"Strudwick, Jason",D,07/17/1975,"Edmonton, Alberta",Canada,674,13,42,55,811
"Strueby, Todd",F,06/15/1963,"Lanigan, Saskatchewan",Canada,5,0,1,1,2
"Stuart, Billy",D,02/01/1900,"Sackville, New Brunswick",Canada,195,30,19,49,155
"Stuart, Brad",D,11/06/1979,"Rocky Mountain House, Alberta",Canada,1056,80,255,335,565
"Stuart, Colin",F,07/08/1982,"Rochester, Minnesota",United States,56,8,5,13,26
"Stuart, Herb",G,03/30/1899,"Brantford, Ontario",Canada,3,0,0,0,0
"Stuart, Mark",D,04/27/1984,"Rochester, Minnesota",United States,673,26,67,93,722
"Stuart, Mike",D,08/31/1980,"Rochester, Minnesota",United States,3,0,0,0,0
"Studenic, Marian",F,10/28/1998,Holic,Slovakia,41,3,3,6,10
"Studnicka, Jack",F,02/18/1999,"Windsor, Ontario",Canada,37,1,6,7,6
"Stumpel, Jozef",F,07/20/1972,Nitra,Slovakia,957,196,481,677,245
"Stumpf, Robert",F,04/25/1953,"Milo, Alberta",Canada,10,1,1,2,20
"Sturgeon, Peter",F,02/12/1954,"Whitehorse, Yukon",Canada,6,0,1,1,2
"Sturm, Marco",F,09/08/1978,Dingolfing,Germany,938,242,245,487,446
"Sturm, Nico",F,05/03/1995,Augsburg,Germany,132,20,19,39,31
"Stutzel, Mike",F,02/28/1979,"Victoria, British Columbia",Canada,9,0,0,0,0
"Stützle, Tim",F,01/15/2002,Viersen,Germany,132,34,53,87,51
"Subban, Malcolm",G,12/21/1993,"Rexdale, Ontario",Canada,86,0,0,0,6
"Subban, P.K.",D,05/13/1989,"Toronto, Ontario",Canada,834,115,352,467,905
"Suchy, Radoslav",D,04/07/1976,Kezmarok,Slovakia,451,13,58,71,104
"Suess, C.J.",F,03/17/1994,"Forest Lake, Minnesota",United States,4,0,0,0,2
"Suglobov, Alexander",F,01/15/1982,Elektrostal,Russia,18,1,0,1,4
"Suikkanen, Kai",F,06/29/1959,Parkano,Finland,2,0,0,0,0
"Sulak, Libor",D,03/04/1994,Pelhrimov,Czech Republic,6,0,0,0,6
"Sulliman, Doug",F,08/29/1959,"Glace Bay, Nova Scotia",Canada,631,160,168,328,175
"Sullivan, Barry",F,09/21/1927,"Preston, Ontario",Canada,1,0,0,0,0
"Sullivan, Bob",F,11/29/1957,"Rouyn-Noranda, Quebec",Canada,62,18,19,37,18
"Sullivan, Brian",F,04/23/1969,"South Windsor, Connecticut",United States,2,0,1,1,0
"Sullivan, Frank",D,06/16/1929,"Toronto, Ontario",Canada,8,0,0,0,2
"Sullivan, Mike",F,02/27/1968,"Marshfield, Massachusetts",United States,709,54,82,136,203
"Sullivan, Pete",F,07/25/1951,"Toronto, Ontario",Canada,126,28,54,82,40
"Sullivan, Red",F,12/24/1929,"Peterborough, Ontario",Canada,557,107,239,346,437
"Sullivan, Steve",F,07/06/1974,"Timmins, Ontario",Canada,1011,290,457,747,587
"Sulzer, Alexander",D,05/30/1984,Kaufbeuren,Germany,131,7,15,22,44
"Summanen, Raimo",F,03/02/1962,Jyväskylä,Finland,151,36,40,76,35
"Summerhill, Bill",F,07/09/1915,"Toronto, Ontario",Canada,72,14,17,31,70
"Summers, Chris",D,02/05/1988,"Ann Arbor, Michigan",United States,70,2,7,9,51
"Sundblad, Niklas",F,01/03/1973,Stockholm,Sweden,2,0,0,0,0
"Sundin, Mats",F,02/13/1971,Bromma,Sweden,1346,564,785,1349,1093
"Sundin, Ronnie",D,10/03/1970,Ludvika,Sweden,1,0,0,0,0
"Sundqvist, Oscar",F,03/23/1994,Boden,Sweden,288,40,55,95,113
"Sundström, Johan",F,09/21/1992,Göteborg,Sweden,11,0,1,1,6
"Sundström, Niklas",F,06/06/1975,Örnsköldsvik,Sweden,750,117,232,349,256
"Sundström, Patrik",F,12/14/1961,Skellefteå,Sweden,679,219,369,588,349
"Sundström, Peter",F,12/14/1961,Skellefteå,Sweden,338,61,83,144,122
"Suomela, Antti",F,03/17/1994,Espoo,Finland,51,4,11,15,8
"Suomi, Al",F,10/29/1913,"Eveleth, Minnesota",United States,5,0,0,0,0
"Surma, Damian",F,01/22/1981,"Lincoln Park, Michigan",United States,2,1,1,2,0
"Surovy, Tomas",F,09/24/1981,Banska Bystrica,Slovakia,126,27,32,59,71
"Sushinsky, Maxim",F,07/01/1974,Saint Petersburg,Russia,30,7,4,11,29
"Sushko, Maxim",F,02/10/1999,Brest,Belarus,2,0,0,0,0
"Sustr, Andrej",D,11/29/1990,Plzen,Czech Republic,361,11,58,69,163
"Suter, Gary",D,06/24/1964,"Madison, Wisconsin",United States,1145,203,641,844,1349
"Suter, Pius",F,05/24/1996,Wallisellen,Switzerland,137,29,34,63,36
"Suter, Ryan",D,01/21/1985,"Madison, Wisconsin",United States,1280,100,539,639,707
"Sutherby, Brian",F,03/01/1982,"Edmonton, Alberta",Canada,460,41,49,90,533
"Sutherland, Bill",F,11/10/1934,"Regina, Saskatchewan",Canada,250,70,58,128,99
"Sutherland, Max",D,02/08/1907,"Grenfell, Saskatchewan",Canada,2,0,0,0,0
"Sutter, Brandon",F,02/14/1989,"Huntington, New York",United States,770,152,137,289,149
"Sutter, Brent",F,06/10/1962,"Viking, Alberta",Canada,1111,363,466,829,1054
"Sutter, Brett",F,06/02/1987,"Viking, Alberta",Canada,60,2,8,10,40
"Sutter, Brian",F,10/07/1956,"Viking, Alberta",Canada,779,303,333,636,1786
"Sutter, Brody",F,09/26/1991,"Calgary, Alberta",Canada,12,0,0,0,0
"Sutter, Darryl",F,08/19/1958,"Viking, Alberta",Canada,406,161,118,279,286
"Sutter, Duane",F,03/16/1960,"Viking, Alberta",Canada,731,139,203,342,1333
"Sutter, Rich",F,12/02/1963,"Viking, Alberta",Canada,874,149,166,315,1411
"Sutter, Ron",F,12/02/1963,"Viking, Alberta",Canada,1093,205,330,535,1354
"Sutton, Andy",D,03/10/1975,"Kingston, Ontario",Canada,676,38,112,150,1185
"Sutton, Ken",D,11/05/1969,"Edmonton, Alberta",Canada,388,23,80,103,338
"Suzor, Mark",D,11/05/1956,"Windsor, Ontario",Canada,64,4,16,20,60
"Suzuki, Nicholas",F,08/10/1999,"London, Ontario",Canada,209,49,94,143,62
"Svartvadet, Per",F,05/17/1975,Sollefteå,Sweden,247,17,34,51,58
"Svatos, Marek",F,06/17/1982,Kosice,Slovakia,344,100,72,172,217
"Svechnikov, Andrei",F,03/26/2000,Barnaul,Russia,283,89,120,209,239
"Svechnikov, Evgeny",F,10/31/1996,Barnaul,Russia,113,12,19,31,58
"Svedberg, Niklas",G,09/04/1989,Sollentuna,Sweden,19,0,0,0,0
"Svedberg, Viktor",D,05/24/1991,Göteborg,Sweden,27,2,2,4,4
"Svehla, Robert",D,01/02/1969,Martin,Slovakia,655,68,267,335,649
"Svejkovský, Jaroslav",F,10/01/1976,Plzen,Czech Republic,113,23,19,42,56
"Svensson, Leif",D,07/08/1951,Härnösand,Sweden,121,6,40,46,49
"Svensson, Magnus",D,03/01/1963,Tranås,Sweden,46,4,14,18,31
"Svitov, Alexander",F,11/03/1982,Omsk,Russia,179,13,24,37,223
"Svoboda, Jaroslav",F,06/01/1980,Cervenka,Czech Republic,134,12,17,29,62
"Svoboda, Petr",D,02/14/1966,Most,Czech Republic,1028,58,341,399,1605
"Svoboda, Petr",D,06/20/1980,Jihlava,Czech Republic,18,1,2,3,10
"Swain, Garry",F,09/11/1947,"Welland, Ontario",Canada,9,1,1,2,0
"Swanson, Brian",F,03/24/1976,"Eagle River, Alaska",United States,70,4,13,17,16
"Swarbrick, George",F,02/16/1942,"Moose Jaw, Saskatchewan",Canada,132,17,25,42,173
"Swayman, Jeremy",G,11/24/1998,"Anchorage, Alaska",United States,51,0,0,0,6
"Sweatt, Bill",F,09/21/1988,"Elburn, Illinois",United States,3,0,0,0,0
"Sweatt, Lee",D,08/13/1985,"Elburn, Illinois",United States,3,1,1,2,2
"Sweeney, Bill",F,01/30/1937,"Guelph, Ontario",Canada,4,1,0,1,0
"Sweeney, Bob",F,01/25/1964,"Concord, Massachusetts",United States,639,125,163,288,804
"Sweeney, Don",D,08/17/1966,"St. Stephen, New Brunswick",Canada,1115,52,221,273,681
"Sweeney, Tim",F,04/12/1967,"Weymouth, Massachusetts",United States,291,55,83,138,123
"Sydor, Darryl",D,05/13/1972,"Edmonton, Alberta",Canada,1291,98,409,507,755
"Sykes, Bob",F,09/26/1951,"Sudbury, Ontario",Canada,2,0,0,0,0
"Sykes, Phil",F,03/18/1959,"Dawson Creek, British Columbia",Canada,456,79,85,164,519
"Sýkora, Michal",D,07/05/1973,Pardubice,Czech Republic,267,15,54,69,185
"Sýkora, Petr",F,11/19/1976,Plzen,Czech Republic,1017,323,398,721,455
"Sýkora, Petr",F,12/21/1978,Pardubice,Czech Republic,12,2,2,4,6
"Sylvester, Dean",F,12/30/1972,"Hanson, Massachusetts",United States,96,21,16,37,32
"Sylvestri, Don",G,06/02/1961,"Sudbury, Ontario",Canada,3,0,0,0,2
"Syvret, Danny",D,06/13/1985,"Millgrove, Ontario",Canada,59,3,4,7,30
"Szczechura, Paul",F,11/30/1985,"Brantford, Ontario",Canada,92,10,10,20,34
"Szura, Joe",F,12/18/1938,"Thunder Bay, Ontario",Canada,90,10,15,25,30
"Szwarz, Jordan",F,05/14/1991,"Burlington, Ontario",Canada,50,4,3,7,25
"Søgaard, Mads",G,12/13/2000,Aalborg,Denmark,2,0,0,0,0
"Tabaracci, Rick",G,01/02/1969,"Toronto, Ontario",Canada,286,0,8,8,72
"Taffe, Jeff",F,02/19/1981,"Hastings, Minnesota",United States,180,21,25,46,40
"Taft, John",D,03/08/1954,"Minneapolis, Minnesota",United States,15,0,2,2,4
"Taglianetti, Peter",D,08/15/1963,"Framingham, Massachusetts",United States,451,18,74,92,1106
"Takko, Kari",G,06/23/1962,Uusikaupunki,Finland,142,0,2,2,30
"Talafous, Dean",F,08/25/1953,"Duluth, Minnesota",United States,497,104,154,258,163
"Talakoski, Ron",F,06/01/1962,"Thunder Bay, Ontario",Canada,9,0,1,1,33
"Talbot, Cameron",G,07/05/1987,"Caledonia, Ontario",Canada,396,0,4,4,35
"Talbot, Jean-Guy",D,07/11/1932,"Cap-de-la-Madeleine, Quebec",Canada,1066,43,242,285,1014
"Talbot, Maxime",F,02/11/1984,"Lemoyne, Quebec",Canada,704,91,113,204,495
"Tallackson, Barry",F,04/14/1983,"Grafton, North Dakota",United States,20,1,1,2,2
"Tallas, Robbie",G,03/20/1973,"Edmonton, Alberta",Canada,99,0,0,0,6
"Tallinder, Henrik",D,01/10/1979,Stockholm,Sweden,678,28,114,142,378
"Tallon, Dale",D,10/19/1950,"Rouyn-Noranda, Quebec",Canada,642,98,238,336,568
"Tambellini, Jeff",F,04/13/1984,"Calgary, Alberta",Canada,242,27,36,63,88
"Tambellini, Steve",F,05/14/1958,"Trail, British Columbia",Canada,553,160,150,310,105
"Tamer, Chris",D,11/17/1970,"Dearborn, Michigan",United States,644,21,64,85,1183
"Tanabe, David",D,07/19/1980,"White Bear Lake, Minnesota",United States,449,30,84,114,245
"Tancill, Chris",F,02/07/1968,"Livonia, Michigan",United States,134,17,32,49,54
"Tanev, Brandon",F,12/31/1991,"Toronto, Ontario",Canada,325,51,56,107,138
"Tanev, Christopher",D,12/20/1989,"Toronto, Ontario",Canada,652,30,128,158,149
"Tangradi, Eric",F,02/10/1989,"Philadelphia, Pennsylvania",United States,150,5,11,16,86
"Tanguay, Alex",F,11/21/1979,"Sainte-Justine, Quebec",Canada,1088,283,580,863,527
"Tanguay, Chris",F,08/04/1962,"Beauport, Quebec",Canada,2,0,0,0,0
"Tannahill, Don",F,02/21/1949,"Penetanguishene, Ontario",Canada,111,30,33,63,25
"Tanner, John",G,03/17/1971,"Cambridge, Ontario",Canada,21,0,0,0,6
"Tanti, Tony",F,09/07/1963,"Toronto, Ontario",Canada,697,287,273,560,661
"Taormina, Matt",D,10/20/1986,"Warren, Michigan",United States,59,4,8,12,6
"Tapper, Brad",F,04/28/1978,"Scarborough, Ontario",Canada,71,14,11,25,72
"Tarasenko, Vladimir",F,12/13/1991,Novosibirsk,Russia,606,252,272,524,177
"Tarasov, Daniil",G,03/27/1999,Novokuznetsk,Russia,4,0,0,0,0
"Tarasov, Daniil",F,06/20/1991,Moscow,Russia,5,0,1,1,0
"Tardif, Jamie",F,01/23/1985,"Welland, Ontario",Canada,2,0,0,0,0
"Tardif, Marc",F,06/12/1949,"Granby, Quebec",Canada,517,194,207,401,445
"Tardif, Patrice",F,10/30/1970,"Thetford Mines, Quebec",Canada,65,7,11,18,78
"Tarkki, Iiro",G,07/01/1985,Rauma,Finland,1,0,0,0,0
"Tarnasky, Nick",F,11/25/1984,"Rocky Mountain House, Alberta",Canada,245,13,17,30,297
"Tärnström, Dick",D,01/20/1975,Sundbyberg,Sweden,306,35,105,140,254
"Tatar, Tomas",F,12/01/1990,Ilava,Slovakia,701,191,216,407,246
"Tatarinov, Mikhail",D,07/16/1966,Angarsk,Russia,161,21,48,69,184
"Tataryn, Dave",G,07/17/1950,"Sudbury, Ontario",Canada,2,0,0,0,0
"Tatchell, Spence",D,07/16/1924,"Lloydminster, Saskatchewan",Canada,1,0,0,0,0
"Tatícek, Petr",F,09/22/1983,Rakovnik,Czech Republic,3,0,0,0,0
"Tavares, John",F,09/20/1990,"Mississauga, Ontario",Canada,949,391,504,895,411
"Taylor, Billy",F,05/03/1919,"Winnipeg, Manitoba",Canada,321,87,179,266,120
"Taylor, Billy",F,10/14/1942,"Winnipeg, Manitoba",Canada,2,0,0,0,0
"Taylor, Bob",F,08/12/1904,"Newton, Massachusetts",United States,6,0,0,0,4
"Taylor, Bobby",G,01/24/1945,"Calgary, Alberta",Canada,45,0,1,1,4
"Taylor, Chris",F,03/06/1972,"Stratford, Ontario",Canada,149,11,21,32,48
"Taylor, Daniel",G,04/28/1986,"Plymouth, England",United Kingdom,4,0,0,0,0
"Taylor, Dave",F,12/04/1955,"Levack, Ontario",Canada,1111,431,638,1069,1589
"Taylor, Harry",F,03/28/1926,"St. James, Manitoba",Canada,66,5,10,15,30
"Taylor, Mark",F,01/26/1958,"Vancouver, British Columbia",Canada,209,42,68,110,73
"Taylor, Ralph",D,10/02/1905,"Toronto, Ontario",Canada,102,4,1,5,174
"Taylor, Ted",F,02/25/1942,"Oak Lake, Manitoba",Canada,166,23,35,58,184
"Taylor, Tim",F,02/06/1969,"Stratford, Ontario",Canada,746,73,94,167,433
"Teal, Jeff",F,05/30/1960,"Edina, Minnesota",United States,6,0,1,1,0
"Teal, Skip",F,07/17/1933,"Ridgeway, Ontario",Canada,1,0,0,0,0
"Teal, Victor",F,08/10/1949,"St. Catharines, Ontario",Canada,1,0,0,0,0
"Tebbutt, Greg",D,05/11/1957,"North Vancouver, British Columbia",Canada,26,0,3,3,35
"Tedenby, Mattias",F,02/21/1990,Vetlanda,Sweden,120,10,20,30,42
"Tellqvist, Mikael",G,09/19/1979,Sundbyberg,Sweden,113,0,2,2,2
"Tenkrát, Petr",F,05/31/1977,Kladno,Czech Republic,177,22,30,52,84
"Tennyson, Matt",D,04/23/1990,"Minneapolis, Minnesota",United States,173,4,25,29,44
"Teno, Harvey",G,02/15/1915,"Windsor, Ontario",Canada,5,0,0,0,0
"Tenute, Joey",F,04/02/1983,"Hamilton, Ontario",Canada,1,0,0,0,0
"Tepper, Steve",F,03/10/1969,"Santa Ana, California",United States,1,0,0,0,0
"Teräväinen, Teuvo",F,09/11/1994,Helsinki,Finland,526,118,251,369,100
"Terbenche, Paul",D,09/16/1945,"Port Hope, Ontario",Canada,189,5,26,31,28
"Terreri, Chris",G,11/15/1964,"Providence, Rhode Island",United States,406,0,13,13,37
"Terrion, Greg",F,05/02/1960,"Marmora, Ontario",Canada,561,93,150,243,339
"Terry, Bill",F,07/13/1961,"Toronto, Ontario",Canada,5,0,0,0,0
"Terry, Chris",F,04/07/1989,"Brampton, Ontario",Canada,152,22,16,38,34
"Terry, Troy",F,09/10/1997,"Highlands Ranch, Colorado",United States,204,52,63,115,52
"Tertyshny, Dmitri",D,12/26/1976,Chelyabinsk,Russia,62,2,8,10,30
"Tessier, Orval",F,06/30/1933,"Cornwall, Ontario",Canada,59,5,7,12,6
"Tetarenko, Joey",F,03/03/1978,"Prince Albert, Saskatchewan",Canada,73,4,1,5,176
"Teubert, Colten",D,03/08/1990,"White Rock, British Columbia",Canada,24,0,1,1,25
"Teves, Josh",D,02/18/1995,"Calgary, Alberta",Canada,1,0,0,0,2
"Texier, Alexandre",F,09/13/1999,Saint-Martin-d'Hères,France,123,22,27,49,44
"Tezikov, Alexei",D,06/22/1978,Togliatti,Russia,30,1,1,2,2
"Thang, Ryan",F,05/11/1987,"Chicago, Illinois",United States,1,0,0,0,0
"Theberge, Greg",D,09/03/1959,"Peterborough, Ontario",Canada,153,15,63,78,73
"Thelin, Mats",D,03/30/1961,Stockholm,Sweden,163,8,19,27,176
"Thelven, Michael",D,01/07/1961,Stockholm,Sweden,207,20,80,100,217
"Théodore, José",G,09/13/1976,"Laval, Quebec",Canada,648,1,16,17,40
"Theodore, Shea",D,08/03/1995,"Langley, British Columbia",Canada,395,58,165,223,127
"Therien, Chris",D,12/14/1971,"Ottawa, Ontario",Canada,764,29,130,159,585
"Therrien, Gaston",D,05/27/1960,"Montréal, Quebec",Canada,22,0,8,8,12
"Thibaudeau, Gilles",F,03/04/1963,"Montréal, Quebec",Canada,119,25,37,62,40
"Thibault, Jocelyn",G,01/12/1975,"Montréal, Quebec",Canada,586,0,6,6,18
"Thibeault, Lorrain",F,10/02/1918,"Charlestone, Ontario",Canada,6,0,2,2,2
"Thiessen, Brad",G,03/19/1986,"Aldergrove, British Columbia",Canada,5,0,0,0,2
"Thomas, Ben",D,05/28/1996,"Calgary, Alberta",Canada,5,0,0,0,0
"Thomas, Bill",F,06/20/1983,"Pittsburgh, Pennsylvania",United States,87,16,12,28,18
"Thomas, Christian",F,05/26/1992,"Toronto, Ontario",Canada,27,1,2,3,9
"Thomas, Cy",F,08/05/1926,"Dowlais, Wales",United Kingdom,14,2,2,4,12
"Thomas, Reg",F,04/21/1953,"Lambeth, Ontario",Canada,39,9,7,16,6
"Thomas, Robert",F,07/02/1999,"Aurora, Ontario",Canada,241,42,122,164,58
"Thomas, Scott",F,01/18/1970,"Buffalo, New York",United States,63,6,4,10,32
"Thomas, Steve",F,07/15/1963,"Stockport, England",United Kingdom,1235,421,512,933,1306
"Thomas, Tim",G,04/15/1974,"Flint, Michigan",United States,426,0,7,7,43
"Thomas, Wayne",G,10/09/1947,"Ottawa, Ontario",Canada,243,0,7,7,41
"Thomlinson, Dave",F,10/22/1966,"Edmonton, Alberta",Canada,42,1,3,4,50
"Thompson, Brent",D,01/09/1971,"Calgary, Alberta",Canada,121,1,10,11,352
"Thompson, Cliff",D,12/09/1918,"Winchester, Massachusetts",United States,16,0,1,1,2
"Thompson, Errol",F,05/28/1950,"Summerside, Prince Edward Island",Canada,599,208,185,393,184
"Thompson, Kenneth",F,05/29/1881,"Oakengates, England",United Kingdom,1,0,0,0,0
"Thompson, Logan",G,02/25/1997,"Calgary, Alberta",Canada,20,0,0,0,0
"Thompson, Nate",F,10/05/1984,"Anchorage, Alaska",United States,844,65,99,164,401
"Thompson, Paul",F,11/30/1988,"Derry, New Hampshire",United States,24,0,3,3,24
"Thompson, Paul",F,11/02/1906,"Calgary, Alberta",Canada,582,153,178,331,346
"Thompson, Rocky",F,08/08/1977,"Calgary, Alberta",Canada,25,0,0,0,117
"Thompson, Tage",F,10/30/1997,"Oyster Bay, New York",United States,223,56,47,103,86
"Thompson, Tiny",G,05/31/1903,"Sandon, British Columbia",Canada,553,0,1,1,0
"Thompson, Tyce",F,07/12/1999,"Milford, Connecticut",United States,9,0,1,1,0
"Thoms, Bill",F,03/05/1910,"Newmarket, Ontario",Canada,549,135,207,342,172
"Thomson, Ben",F,01/16/1993,"Brampton, Ontario",Canada,3,0,0,0,4
"Thomson, Bill",F,03/23/1914,"Troon, Scotland",United Kingdom,9,2,2,4,0
"Thomson, Floyd",F,06/14/1949,"Sudbury, Ontario",Canada,411,56,97,153,341
"Thomson, Jim",F,12/30/1965,"Edmonton, Alberta",Canada,115,4,3,7,416
"Thomson, Jimmy",D,02/23/1927,"Winnipeg, Manitoba",Canada,787,19,215,234,920
"Thomson, Lassi",D,09/24/2000,Tampere,Finland,16,0,5,5,2
"Thomson, Rhys",D,08/09/1918,"Toronto, Ontario",Canada,25,0,2,2,38
"Thorburn, Chris",F,06/03/1983,"Sault Ste. Marie, Ontario",Canada,801,53,81,134,968
"Thoresen, Patrick",F,11/07/1983,Oslo,Norway,106,6,18,24,66
"Thornbury, Tom",D,03/17/1963,"Lindsay, Ontario",Canada,14,1,8,9,16
"Thornton, Joe",F,07/02/1979,"London, Ontario",Canada,1714,430,1109,1539,1272
"Thornton, Scott",F,01/09/1971,"London, Ontario",Canada,941,144,141,285,1459
"Thornton, Shawn",F,07/23/1977,"Oshawa, Ontario",Canada,705,42,60,102,1103
"Thorsteinson, Joe",F,03/19/1905,"Winnipeg, Manitoba",Canada,4,0,0,0,0
"Thuresson, Andreas",F,11/18/1987,Kristianstad,Sweden,25,1,2,3,6
"Thurier, Fred",F,01/11/1916,"Granby, Quebec",Canada,80,25,27,52,18
"Thürkauf, Calvin",F,06/27/1997,Zug,Switzerland,3,0,0,0,0
"Thurlby, Tom",D,11/09/1938,"Kingston, Ontario",Canada,21,1,1,2,4
"Thyer, Mario",F,09/29/1966,"Montréal, Quebec",Canada,5,0,0,0,0
"Tibbetts, Billy",F,10/14/1974,"Boston, Massachusetts",United States,82,2,8,10,269
"Tichý, Milan",D,09/22/1969,Plzen,Czech Republic,23,0,5,5,40
"Tidey, Alex",F,01/05/1955,"Vancouver, British Columbia",Canada,9,0,0,0,8
"Tierney, Chris",F,07/01/1994,"Keswick, Ontario",Canada,561,73,153,226,108
"Tikhonov, Viktor",F,05/12/1988,Riga,Latvia,111,11,11,22,40
"Tikkanen, Esa",F,01/25/1965,Helsinki,Finland,877,244,386,630,1077
"Tiley, Brad",D,07/05/1971,"Markdale, Ontario",Canada,11,0,0,0,0
"Tilley, Tom",D,03/28/1965,"Trenton, Ontario",Canada,174,4,38,42,89
"Timander, Mattias",D,04/16/1974,Ramsele,Sweden,419,13,57,70,165
"Timashov, Dmytro",F,10/01/1996,Kirovograd,Ukraine,45,4,5,9,16
"Timgren, Ray",F,09/29/1928,"Windsor, Ontario",Canada,251,14,44,58,70
"Timmins, Conor",D,09/18/1998,"Thorold, Ontario",Canada,39,0,7,7,8
"Timmins, Scott",F,09/11/1989,"Hamilton, Ontario",Canada,24,1,0,1,12
"Timonen, Jussi",D,06/29/1983,Kuopio,Finland,14,0,4,4,6
"Timonen, Kimmo",D,03/18/1975,Kuopio,Finland,1108,117,454,571,654
"Tinordi, Jarred",F,02/20/1992,"Burnsville, Minnesota",United States,109,2,11,13,130
"Tinordi, Mark",D,05/09/1966,"Red Deer, Alberta",Canada,663,52,148,200,1514
"Tippett, Dave",F,08/25/1961,"Moosomin, Saskatchewan",Canada,721,93,169,262,317
"Tippett, Owen",F,02/16/1999,"Peterborough, Ontario",Canada,115,18,22,40,18
"Titanic, Morris",F,01/07/1953,"Toronto, Ontario",Canada,19,0,0,0,0
"Titov, German",F,10/16/1965,Moscow,Russia,624,157,220,377,311
"Tjärnqvist, Daniel",D,10/14/1976,Umeå,Sweden,352,18,72,90,130
"Tjärnqvist, Mathias",F,04/15/1979,Umeå,Sweden,173,13,19,32,60
"Tkachuk, Brady",F,09/16/1999,"St. Louis, Missouri",United States,277,90,102,192,367
"Tkachuk, Keith",F,03/28/1972,"Melrose, Massachusetts",United States,1201,538,527,1065,2219
"Tkachuk, Matthew",F,12/11/1997,"Scottsdale, Arizona",United States,431,152,230,382,425
"Tkachyov, Vladimir",F,10/05/1995,Omsk,Russia,4,0,2,2,2
"Tkaczuk, Daniel",F,06/10/1979,"Toronto, Ontario",Canada,19,4,7,11,14
"Tkaczuk, Walt",F,09/29/1947,Emsdetten,Germany,945,227,451,678,556
"Tlusty, Jirí",F,03/16/1988,Slany,Czech Republic,446,89,88,177,126
"Toal, Mike",F,03/23/1959,"Red Deer, Alberta",Canada,3,0,0,0,0
"Tobler, Ryan",F,05/13/1976,"Calgary, Alberta",Canada,4,0,0,0,5
"Tocchet, Rick",F,04/09/1964,"Scarborough, Ontario",Canada,1144,440,512,952,2970
"Todd, Kevin",F,05/04/1968,"Winnipeg, Manitoba",Canada,383,70,133,203,225
"Toews, Devon",D,02/21/1994,"Abbotsford, British Columbia",Canada,235,33,101,134,56
"Toews, Jonathan",F,04/29/1988,"Winnipeg, Manitoba",Canada,1014,357,495,852,564
"Toffoli, Tyler",F,04/24/1992,"Toronto, Ontario",Canada,651,193,200,393,188
"Toivonen, Hannu",G,05/18/1984,Kalvola,Finland,61,0,0,0,10
"Tokarski, Dustin",G,09/16/1989,"Humboldt, Saskatchewan",Canada,76,0,3,3,2
"Tolchinsky, Sergei",F,02/03/1995,Moscow,Russia,4,0,2,2,0
"Tollefsen, Ole-Kristian",D,03/29/1984,Oslo,Norway,163,4,8,12,296
"Tolpeko, Denis",F,01/29/1985,Moscow,Russia,26,1,5,6,24
"Tolvanen, Eeli",F,04/22/1999,Vihti,Finland,122,23,24,47,20
"Tomalty, Glenn",D,07/23/1954,"Lachute, Quebec",Canada,1,0,0,0,0
"Tomasino, Philip",F,07/28/2001,"Mississauga, Ontario",Canada,76,11,21,32,10
"Tomlak, Mike",F,10/17/1965,"Thunder Bay, Ontario",Canada,141,15,22,37,103
"Tomlinson, Dave",F,05/08/1969,"North Vancouver, British Columbia",Canada,42,1,3,4,28
"Tomlinson, Kirk",F,05/02/1968,"Toronto, Ontario",Canada,1,0,0,0,0
"Toms, Jeff",F,06/04/1974,"Swift Current, Saskatchewan",Canada,236,22,33,55,59
"Tomson, Jack",D,01/31/1918,"Uxbridge, England",United Kingdom,15,1,0,1,0
"Tonelli, John",F,03/23/1957,"Hamilton, Ontario",Canada,1028,325,511,836,911
"Toninato, Dominic",F,03/09/1994,"Duluth, Minnesota",United States,164,12,17,29,71
"Tookey, Tim",F,08/29/1960,"Edmonton, Alberta",Canada,106,22,36,58,71
"Toomey, Sean",F,06/27/1965,"St. Paul, Minnesota",United States,1,0,0,0,0
"Tootoo, Jordin",F,02/02/1983,"Churchill, Manitoba",Canada,723,65,96,161,1010
"Toporowski, Shayne",F,08/06/1975,"Paddockwood, Saskatchewan",Canada,3,0,0,0,7
"Toppazzini, Jerry",F,07/29/1931,"Copper Cliff, Ontario",Canada,784,163,244,407,433
"Toppazzini, Zellio",F,01/05/1930,"Copper Cliff, Ontario",Canada,123,21,21,42,49
"Torchia, Mike",G,02/23/1972,"Toronto, Ontario",Canada,6,0,0,0,0
"Tordjman, Josh",G,01/11/1985,"Montréal, Quebec",Canada,2,0,0,0,0
"Torgajev, Pavel",F,01/25/1966,Nizhny Novgorod,Russia,55,6,14,20,20
"Torkki, Jari",F,08/11/1965,Rauma,Finland,4,1,0,1,0
"Törmänen, Antti",F,09/19/1970,Espoo,Finland,50,7,8,15,28
"Toropchenko, Alexei",F,06/25/1999,Moscow,Russia,28,2,0,2,15
"Torres, Raffi",F,10/08/1981,"Toronto, Ontario",Canada,635,137,123,260,497
"Toskala, Vesa",G,05/20/1977,Tampere,Finland,266,0,10,10,16
"Touhey, Bill",F,03/23/1906,"Ottawa, Ontario",Canada,280,65,38,103,92
"Toupin, Jacques",F,11/10/1910,"Trois-Rivières, Quebec",Canada,8,1,2,3,0
"Townsend, Art",F,10/09/1905,"Souris, Manitoba",Canada,5,0,0,0,0
"Townshend, Graeme",F,10/23/1965,Kingston,Jamaica,45,3,7,10,28
"Tracey, Brayden",F,05/28/2001,"Calgary, Alberta",Canada,1,0,0,0,0
"Trader, Larry",D,07/07/1963,"Barry's Bay, Ontario",Canada,91,5,13,18,74
"Trainor, Wes",F,09/11/1922,"Charlottetown, Prince Edward Island",Canada,17,1,2,3,6
"Trapp, Bobby",D,12/16/1899,"Pembroke, Ontario",Canada,82,4,4,8,131
"Trapp, Doug",F,11/28/1965,"Balcarres, Saskatchewan",Canada,2,0,0,0,0
"Traub, Percy 'Puss'",D,08/23/1896,"Elmwood, Ontario",Canada,130,3,3,6,225
"Traverse, Patrick",D,03/14/1974,"Montréal, Quebec",Canada,279,14,51,65,113
"Trebil, Dan",D,04/10/1974,"Bloomington, Minnesota",United States,85,4,4,8,32
"Trefilov, Andrei",G,08/31/1969,Kirovo-Chepetsk,Russia,54,0,0,0,10
"Tremblay, Brent",D,11/01/1957,"North Bay, Ontario",Canada,10,1,0,1,6
"Tremblay, Gilles",F,12/17/1938,"Montmorency, Quebec",Canada,509,168,162,330,164
"Tremblay, J.C.",D,01/22/1939,"Bagotville, Quebec",Canada,796,57,306,363,206
"Tremblay, Marcel",F,07/04/1915,"St. Boniface, Manitoba",Canada,10,0,2,2,0
"Tremblay, Mario",F,09/02/1956,"Alma, Quebec",Canada,852,258,326,584,1043
"Tremblay, Nils",F,07/26/1923,"Matane, Quebec",Canada,1,0,1,1,0
"Tremblay, Vince",G,10/21/1959,"Québec City, Quebec",Canada,58,0,2,2,4
"Tremblay, Yannick",D,11/15/1975,"Pointe-aux-Trembles, Quebec",Canada,390,38,87,125,178
"Trenin, Yakov",F,01/13/1997,Chelyabinsk,Russia,146,24,17,41,77
"Trepanier, Pascal",D,09/04/1973,"Gaspé, Quebec",Canada,229,12,22,34,252
"Treutle, Niklas",G,04/29/1991,Nürnberg,Germany,2,0,0,0,2
"Trimper, Tim",F,09/28/1959,"Windsor, Ontario",Canada,190,30,36,66,153
"Tripp, John",F,05/04/1977,"Kingston, Ontario",Canada,43,2,7,9,35
"Trnka, Pavel",D,07/27/1976,Plzen,Czech Republic,411,14,63,77,323
"Trocheck, Vincent",F,07/11/1993,"Pittsburgh, Pennsylvania",United States,555,150,228,378,372
"Tropp, Corey",F,07/25/1989,"Grosse Pointe, Michigan",United States,149,6,21,27,133
"Trotman, Zach",D,08/26/1990,"Carmel, Indiana",United States,91,3,10,13,30
"Trotter, Brock",F,01/16/1987,"Brandon, Manitoba",Canada,2,0,0,0,0
"Trottier, Bryan",F,07/17/1956,"Val Marie, Saskatchewan",Canada,1279,524,901,1425,912
"Trottier, Dave",F,06/25/1906,"Pembroke, Ontario",Canada,446,121,113,234,521
"Trottier, Guy",F,04/01/1941,"Hull, Quebec",Canada,115,28,17,45,37
"Trottier, Rocky",F,04/11/1964,"Climax, Saskatchewan",Canada,38,6,4,10,2
"Trouba, Jacob",D,02/26/1994,"Rochester, Michigan",United States,597,62,195,257,468
"Truchon-Viel, Jeffrey",F,01/28/1997,"L'Ange-Gardien, Quebec",Canada,45,3,2,5,137
"Trudel, Jean-Guy",F,10/18/1975,"Sudbury, Ontario",Canada,5,0,0,0,4
"Trudel, Lou",F,07/21/1912,"Salem, Massachusetts",United States,310,50,68,118,122
"Trudell, Rene",F,01/31/1919,"Mariapolis, Manitoba",Canada,129,24,28,52,72
"True, Alexander",F,07/17/1997,Copenhagen,Denmark,27,0,5,5,10
"Tryamkin, Nikita",D,08/30/1994,Yekaterinburg,Russia,79,3,8,11,74
"Tselios, Nikos",D,01/20/1979,"Oak Park, Illinois",United States,2,0,0,0,6
"Tsulygin, Nikolai",D,05/29/1975,Ufa,Russia,22,0,1,1,8
"Tsygurov, Denis",D,02/26/1971,Chelyabinsk,Russia,51,1,5,6,45
"Tsyplakov, Vladimir",F,04/18/1969,Inta,Russia,331,69,101,170,90
"Tuch, Alex",F,05/10/1996,"Syracuse, New York",United States,305,73,104,177,85
"Tucker, Darcy",F,03/15/1975,"Castor, Alberta",Canada,947,215,261,476,1410
"Tucker, John",F,09/29/1964,"Windsor, Ontario",Canada,656,177,259,436,285
"Tucker, Ted",G,05/07/1949,"Thunder Bay, Ontario",Canada,5,0,0,0,0
"Tudin, Connie",D,09/21/1917,"Ottawa, Ontario",Canada,4,0,1,1,4
"Tudor, Rob",F,06/30/1956,"Cupar, Saskatchewan",Canada,28,4,4,8,19
"Tuer, Allan",D,07/19/1963,"North Battleford, Saskatchewan",Canada,57,1,1,2,208
"Tufte, Riley",F,04/10/1998,"Coon Rapids, Minnesota",United States,10,1,0,1,4
"Tugnutt, Ron",G,10/22/1967,"Scarborough, Ontario",Canada,537,0,7,7,12
"Tukonen, Lauri",F,09/01/1986,Hyvinkää,Finland,5,0,0,0,0
"Tuomainen, Marko",F,04/25/1972,Kuopio,Finland,79,9,9,18,84
"Turco, Marty",G,08/13/1975,"Sault Ste. Marie, Ontario",Canada,543,0,22,22,168
"Turcotte, Alex",F,02/26/2001,"Walled Lake, Michigan",United States,8,0,0,0,2
"Turcotte, Alfie",F,06/05/1965,"Gary, Indiana",United States,112,17,29,46,49
"Turcotte, Darren",F,03/02/1968,"Boston, Massachusetts",United States,635,195,216,411,301
"Turek, Roman",G,05/21/1970,Strakonice,Czech Republic,328,0,12,12,30
"Turgeon, Dominic",F,02/25/1996,"Cherry Hills Village, Colorado",United States,9,0,0,0,2
"Turgeon, Pierre",F,08/28/1969,"Rouyn-Noranda, Quebec",Canada,1294,515,812,1327,452
"Turgeon, Sylvain",F,01/17/1965,"Rouyn-Noranda, Quebec",Canada,669,269,226,495,691
"Turlick, Gord",F,09/17/1939,"Michel, British Columbia",Canada,2,0,0,0,2
"Turnbull, Ian",D,12/22/1953,"Montréal, Quebec",Canada,628,123,317,440,736
"Turnbull, Perry",F,03/09/1959,"Bentley, Alberta",Canada,608,188,163,351,1247
"Turnbull, Randy",D,02/07/1962,"Bentley, Alberta",Canada,1,0,0,0,2
"Turnbull, Travis",F,07/07/1986,"St. Louis, Missouri",United States,3,1,0,1,5
"Turner, Bob",D,01/31/1934,"Regina, Saskatchewan",Canada,478,19,51,70,307
"Turner, Brad",D,05/25/1968,"Winnipeg, Manitoba",Canada,3,0,0,0,0
"Turner, Dean",D,06/22/1958,"Dearborn, Michigan",United States,35,1,0,1,59
"Turner, Joe",G,03/28/1919,"Windsor, Ontario",Canada,1,0,0,0,0
"Turris, Kyle",F,08/14/1989,"New Westminster, British Columbia",Canada,776,168,257,425,343
"Tustin, Norman",F,01/03/1919,"Regina, Saskatchewan",Canada,18,2,4,6,0
"Tuten, Audley",D,01/14/1915,"Enterprise, Alabama",United States,39,4,8,12,48
"Tutt, Brian",D,06/09/1962,"Swallwell, Alberta",Canada,7,1,0,1,2
"Tuttle, Steve",F,01/05/1966,"Vancouver, British Columbia",Canada,144,28,28,56,12
"Tuzzolino, Tony",F,10/09/1975,"Buffalo, New York",United States,9,0,0,0,7
"Tverdovsky, Oleg",D,05/18/1976,Donetsk,Ukraine,713,77,240,317,291
"Tvrdon, Roman",F,01/29/1981,Trencín,Slovakia,9,0,1,1,2
"Twarynski, Carsen",F,11/24/1997,"Calgary, Alberta",Canada,22,1,0,1,6
"Twist, Tony",F,05/09/1968,"Sherwood Park, Alberta",Canada,445,10,18,28,1121
"Tynan, T.J.",F,02/25/1992,"Orland Park, Illinois",United States,21,0,1,1,2
"Tyrell, Dana",F,04/23/1989,"Airdrie, Alberta",Canada,135,7,17,24,26
"Tyutin, Fedor",D,07/19/1983,Izhevsk,Russia,872,55,209,264,548
"Ubriaco, Gene",F,12/26/1937,"Sault Ste. Marie, Ontario",Canada,177,39,35,74,50
"Uher, Dominik",F,12/31/1992,Frydek-Mistek,Czech Republic,2,0,0,0,0
"Ulanov, Igor",D,10/01/1969,Krasnokamsk,Russia,739,27,135,162,1151
"Ullman, Norm",F,12/26/1935,"Provost, Alberta",Canada,1410,490,739,1229,710
"Ullmark, Linus",G,07/31/1993,Lugnvik,Sweden,158,0,2,2,8
"Ullström, David",F,04/22/1989,Jönköping,Sweden,49,6,7,13,12
"Ulmer, Jeff",F,04/27/1977,"Wilcox, Saskatchewan",Canada,21,3,0,3,8
"Ulmer, Layne",F,09/14/1980,"North Battleford, Saskatchewan",Canada,1,0,0,0,0
"Umberger, R.J.",F,05/03/1982,"Pittsburgh, Pennsylvania",United States,779,180,212,392,312
"Underhill, Matt",G,09/16/1979,"Campbell River, British Columbia",Canada,1,0,0,0,0
"Unger, Garry",F,12/07/1947,"Calgary, Alberta",Canada,1105,413,391,804,1075
"Upshall, Scottie",F,10/07/1983,"Fort McMurray, Alberta",Canada,759,138,146,284,615
"Urbom, Alexander",D,12/20/1990,Stockholm,Sweden,34,3,1,4,28
"Ustorf, Stefan",F,01/03/1974,Kaufbeuren,Germany,54,7,10,17,16
"Vaakanainen, Urho",D,01/01/1999,Joensuu,Finland,45,0,8,8,12
"Väänänen, Ossi",D,08/18/1980,Vantaa,Finland,479,13,55,68,482
"Vachon, Nick",F,07/20/1972,"Montréal, Quebec",Canada,1,0,0,0,0
"Vachon, Rogie",G,09/08/1945,"Palmarolle, Quebec",Canada,795,0,10,10,47
"Vadnais, Carol",D,09/25/1945,"Montréal, Quebec",Canada,1087,169,418,587,1811
"Vaic, Lubomir",F,03/06/1977,Spisska Nova Ves,Slovakia,9,1,1,2,2
"Vail, Eric",F,09/16/1953,"Timmins, Ontario",Canada,591,216,260,476,281
"Vail, Sparky",D,07/05/1906,"Meaford, Ontario",Canada,50,4,1,5,26
"Vaive, Rick",F,05/14/1959,"Ottawa, Ontario",Canada,876,441,347,788,1445
"Valabik, Boris",D,02/14/1986,Nitra,Slovakia,80,0,7,7,210
"Valentine, Chris",F,12/06/1961,"Belleville, Ontario",Canada,105,43,52,95,127
"Valicevic, Robert",F,01/06/1971,"Detroit, Michigan",United States,193,28,20,48,61
"Välimäki, Juuso",D,10/06/1998,Tampere,Finland,82,3,13,16,48
"Valiquette, Jack",F,03/18/1954,"St. Thomas, Ontario",Canada,350,84,134,218,79
"Valiquette, Stephen",G,08/20/1977,"Etobicoke, Ontario",Canada,46,0,1,1,4
"Valiyev, Rinat",D,05/11/1995,Nizhnekamsk,Russia,12,0,0,0,2
"Valk, Curtis",F,02/08/1993,"Medicine Hat, Alberta",Canada,1,0,0,0,0
"Valk, Garry",F,11/27/1967,"Edmonton, Alberta",Canada,777,100,156,256,747
"Vallis, Lindsay",F,01/12/1971,"Winnipeg, Manitoba",Canada,1,0,0,0,0
"Van Allen, Shaun",F,08/29/1967,"Calgary, Alberta",Canada,794,84,185,269,481
"Van Boxmeer, John",D,11/20/1952,"Petrolia, Ontario",Canada,588,84,274,358,465
"Van Brabant, Bryce",F,11/12/1991,"Morinville, Alberta",Canada,6,0,0,0,2
"Van der Gulik, David",F,04/20/1983,"Abbotsford, British Columbia",Canada,49,2,11,13,10
"Van Dorp, Wayne",F,05/19/1961,"Vancouver, British Columbia",Canada,125,12,12,24,570
"Van Drunen, Dave",D,01/31/1976,"Sherwood Park, Alberta",Canada,1,0,0,0,0
"Van Guilder, Mark",F,01/17/1984,"Roseville, Minnesota",United States,1,0,0,0,0
"Van Impe, Darren",D,05/18/1973,"Saskatoon, Saskatchewan",Canada,411,25,90,115,397
"Van Impe, Ed",D,05/27/1940,"Saskatoon, Saskatchewan",Canada,703,27,126,153,1024
"van Riemsdyk, James",F,05/04/1989,"Middletown, New Jersey",United States,879,288,274,562,346
"Van Riemsdyk, Trevor",D,07/24/1991,"Middletown, New Jersey",United States,456,17,72,89,144
"Van Ryn, Mike",D,05/14/1979,"London, Ontario",Canada,353,30,99,129,260
"Vanbiesbrouck, John",G,09/04/1963,"Detroit, Michigan",United States,882,0,35,35,310
"Vande Velde, Chris",F,03/15/1987,"Moorhead, Minnesota",United States,278,18,30,48,95
"Vandenbussche, Ryan",F,02/28/1973,"Simcoe, Ontario",Canada,310,10,10,20,702
"Vandermeer, Jim",D,02/21/1980,"Caroline, Alberta",Canada,461,25,80,105,664
"Vandermeer, Pete",F,10/14/1975,"Red Deer, Alberta",Canada,2,0,0,0,0
"Vanecek, Vitek",G,01/09/1996,Havlickuv Brod,Czech Republic,79,0,0,0,0
"Vanek, Thomas",F,01/19/1984,Vienna,Austria,1029,373,416,789,547
"Varad'a, Václav",F,04/26/1976,Vsetin,Czech Republic,493,58,125,183,410
"Varis, Petri",F,05/13/1969,Varkaus,Finland,1,0,0,0,0
"Varlamov, Semyon",G,04/27/1988,Samara,Russia,560,0,8,8,24
"Varlamov, Sergei",F,07/21/1978,Kiev,Ukraine,63,8,7,15,26
"Varone, Phil",F,12/04/1990,"Vaughan, Ontario",Canada,97,8,9,17,26
"Varvio, Jarkko",F,04/28/1972,Tampere,Finland,13,3,4,7,4
"Vasícek, Josef",F,09/12/1980,Havlickuv Brod,Czech Republic,460,77,106,183,311
"Vasilevski, Alexander",F,01/08/1975,Kiev,Ukraine,4,0,0,0,2
"Vasilevski, Andrei",G,07/25/1994,Tyumen,Russia,365,0,16,16,32
"Vasiliev, Alexei",D,09/01/1977,Yaroslavl,Russia,1,0,0,0,2
"Vasiljevs, Herbert",F,05/27/1976,Riga,Latvia,51,8,7,15,22
"Vasilyev, Andrei",F,03/30/1972,Voskresensk,Russia,16,2,5,7,6
"Vaske, Dennis",D,10/11/1967,"Rockford, Illinois",United States,235,5,41,46,253
"Vasko, Elmer",D,12/11/1935,"Duparquet, Quebec",Canada,786,34,166,200,721
"Vasko, Rick",D,01/12/1957,"St. Catharines, Ontario",Canada,31,3,7,10,29
"Vasyunov, Alexander",F,04/22/1988,Yaroslavl,Russia,18,1,4,5,0
"Vatanen, Sami",D,06/03/1991,Jyväskylä,Finland,473,47,153,200,212
"Vatrano, Frank",F,03/14/1994,"East Longmeadow, Massachusetts",United States,401,101,69,170,178
"Vauclair, Julien",D,10/02/1979,Delemont,Switzerland,1,0,0,0,2
"Vautour, Yvon",F,09/10/1956,"Saint John, New Brunswick",Canada,204,26,33,59,401
"Vaydik, Greg",F,10/09/1955,"Yellowknife, Northwest Territories",Canada,5,0,0,0,0
"Vecchione, Mike",F,02/25/1993,"Saugus, Massachusetts",United States,3,0,0,0,0
"Vehviläinen, Veini",G,02/13/1997,Jyväskylä,Finland,1,0,0,0,0
"Veilleux, Stephane",F,11/16/1981,"Beauceville, Quebec",Canada,506,50,56,106,348
"Veisor, Mike",G,08/25/1952,"Toronto, Ontario",Canada,139,0,3,3,2
"Veitch, Darren",D,04/24/1960,"Saskatoon, Saskatchewan",Canada,511,48,209,257,296
"Vejdemo, Lukas",F,01/25/1996,Stockholm,Sweden,13,2,0,2,0
"Vejmelka, Karel",G,05/25/1996,Trebic,Czech Republic,52,0,0,0,0
"Veleno, Joseph",F,01/13/2000,"Montréal, Quebec",Canada,71,9,7,16,26
"Velischek, Randy",D,02/10/1962,"Montréal, Quebec",Canada,509,21,76,97,401
"Vellucci, Mike",D,08/11/1966,"Farmington, Michigan",United States,2,0,0,0,11
"Venasky, Vic",F,06/03/1951,"Thunder Bay, Ontario",Canada,430,61,101,162,66
"Veneruzzo, Gary",F,06/28/1943,"Thunder Bay, Ontario",Canada,7,1,1,2,0
"Verbeek, Pat",F,05/24/1964,"Sarnia, Ontario",Canada,1424,522,540,1062,2905
"Verhaeghe, Carter",F,08/14/1995,"Waterdown, Ontario",Canada,173,51,53,104,87
"Vermette, Antoine",F,07/20/1982,"Saint-Agapit, Quebec",Canada,1046,228,287,515,622
"Vermette, Mark",F,10/03/1967,"Cochenour, Ontario",Canada,67,5,13,18,33
"Vermin, Joel",F,02/05/1992,Frauenkappelen,Switzerland,24,0,4,4,4
"Vernace, Mike",D,05/26/1986,"Toronto, Ontario",Canada,22,0,1,1,10
"Vernarsky, Kris",F,04/05/1982,"Detroit, Michigan",United States,17,1,0,1,2
"Vernon, Mike",G,02/24/1963,"Calgary, Alberta",Canada,782,0,39,39,271
"Veronneau, Maximilian",F,12/12/1995,"Ottawa, Ontario",Canada,16,2,2,4,0
"Verot, Darcy",F,07/13/1976,"Radville, Saskatchewan",Canada,37,0,2,2,135
"Verret, Claude",F,04/20/1963,"Lachine, Quebec",Canada,14,2,5,7,2
"Versteeg, Kris",F,05/13/1986,"Lethbridge, Alberta",Canada,643,149,209,358,374
"Verstraete, Leigh",F,01/06/1962,"Pincher Creek, Alberta",Canada,8,0,1,1,14
"Ververgaert, Dennis",F,03/30/1953,"Hamilton, Ontario",Canada,583,176,216,392,247
"Vesalainen, Kristian",F,06/01/1999,Helsinki,Finland,70,2,3,5,6
"Vesce, Ryan",F,04/07/1982,"Lloyd Harbor, New York",United States,19,3,2,5,4
"Vesey, Jim",F,09/29/1965,"Charlestown, Massachusetts",United States,15,1,2,3,7
"Vesey, Jimmy",F,05/26/1993,"North Reading, Massachusetts",United States,422,72,63,135,104
"Vey, Linden",F,07/17/1991,"Wakaw, Saskatchewan",Canada,138,14,30,44,24
"Veysey, Sid",F,07/30/1955,"Woodstock, New Brunswick",Canada,1,0,0,0,0
"Vezina, Georges",G,01/21/1887,"Chicoutimi, Quebec",Canada,190,0,1,1,2
"Vial, Dennis",D,04/10/1969,"Sault Ste. Marie, Ontario",Canada,242,4,15,19,794
"Vickers, Steve",F,04/21/1951,"Toronto, Ontario",Canada,698,246,340,586,330
"Vigier, Jean Pierre",F,09/11/1976,"Notre Dame de Lourdes, Manitoba",Canada,213,23,23,46,97
"Vigneault, Alain",D,05/14/1961,"Québec City, Quebec",Canada,42,2,5,7,82
"Viitakoski, Vesa",F,02/13/1971,Lappeenranta,Finland,23,2,4,6,8
"Vilardi, Gabriel",F,08/16/1999,"Kingston, Ontario",Canada,89,18,19,37,18
"Vilgrain, Claude",F,03/01/1963,Port-au-Prince,Haiti,89,21,32,53,78
"Villemure, Gilles",G,05/30/1940,"Trois-Rivières, Quebec",Canada,205,0,2,2,10
"Vincelette, Dan",F,08/01/1967,"Verdun, Quebec",Canada,193,20,22,42,351
"Vincour, Tomas",F,11/19/1990,Brno,Czech Republic,95,7,10,17,12
"Vipond, Pete",F,12/08/1949,"Oshawa, Ontario",Canada,3,0,0,0,0
"Virta, Hannu",D,03/22/1963,Turku,Finland,245,25,101,126,66
"Virta, Tony",F,06/28/1972,Hämeenlinna,Finland,8,2,3,5,0
"Virtanen, Jake",F,08/17/1996,"New Westminster, British Columbia",Canada,317,55,45,100,219
"Virtue, Terry",D,08/12/1970,"Scarborough, Ontario",Canada,5,0,0,0,0
"Visentin, Mark",G,08/07/1992,"Hamilton, Ontario",Canada,1,0,0,0,0
"Visheau, Mark",D,06/27/1973,"Burlington, Ontario",Canada,29,1,3,4,107
"Vishnevski, Vitaly",D,03/18/1980,Kharkiv,Ukraine,552,16,52,68,494
"Vishnevskiy, Ivan",D,02/18/1988,Barnaul,Russia,5,0,2,2,2
"Visnovsky, Lubomir",D,08/11/1976,Topolcany,Slovakia,883,128,367,495,373
"Vitale, Joe",F,08/20/1985,"St. Louis, Missouri",United States,234,11,33,44,156
"Vitolinsh, Harijs",F,04/30/1968,Riga,Latvia,8,0,0,0,4
"Viveiros, Emanuel",D,01/08/1966,"St. Albert, Alberta",Canada,29,1,11,12,6
"Vladar, Daniel",G,08/20/1997,Prague,Czech Republic,28,0,1,1,0
"Vlasak, Tomas",F,02/01/1975,Prague,Czech Republic,10,1,3,4,2
"Vlasic, Alex",D,06/05/2001,"Wilmette, Illinois",United States,15,1,1,2,2
"Vlasic, Marc-Edouard",D,03/30/1987,"Montréal, Quebec",Canada,1161,76,270,346,428
"Vokes, Ed",F,05/27/1909,"Quill Lake, Saskatchewan",Canada,5,0,0,0,0
"Vokoun, Tomas",G,07/02/1976,Karlovy Vary,Czech Republic,700,0,23,23,125
"Volcan, Mickey",D,03/03/1962,"Edmonton, Alberta",Canada,162,8,33,41,146
"Volchenkov, Anton",D,02/25/1982,Moscow,Russia,696,19,114,133,438
"Volchkov, Alexander",F,09/25/1977,Moscow,Russia,3,0,0,0,0
"Volek, David",F,06/18/1966,Prague,Czech Republic,396,95,154,249,201
"Volkov, Alexander",F,08/02/1997,Moscow,Russia,46,7,7,14,12
"Volmar, Doug",F,01/09/1945,"Cleveland, Ohio",United States,62,13,8,21,26
"Volpatti, Aaron",F,05/30/1985,"Revelstoke, British Columbia",Canada,114,5,2,7,137
"Von Arx, Reto",F,09/13/1976,Egerkingen,Switzerland,19,3,1,4,4
"Von Stefenelli, Phil",D,04/10/1969,"Vancouver, British Columbia",Canada,33,0,5,5,23
"Vopat, Jan",D,03/22/1973,Most,Czech Republic,126,11,20,31,70
"Vopat, Roman",F,04/21/1976,Litvinov,Czech Republic,133,6,14,20,253
"Vorácek, Jakub",F,08/15/1989,Kladno,Czech Republic,1047,222,578,800,525
"Vorobiev, Pavel",F,05/05/1982,Karaganda,Kazakhstan,57,10,15,25,38
"Vorobiev, Vladimir",F,10/02/1972,Cherepovets,Russia,33,9,7,16,14
"Vorobyov, Mikhail",F,01/05/1997,Ufa,Russia,35,2,3,5,8
"Voros, Aaron",F,07/02/1981,"Vancouver, British Columbia",Canada,162,18,19,37,395
"Voss, Carl",F,01/06/1907,"Chelsea, Massachusetts",United States,264,34,71,105,50
"Voynov, Vyacheslav",D,01/15/1990,Chelyabinsk,Russia,190,18,63,81,72
"Vrana, Jakub",F,02/28/1996,Prague,Czech Republic,321,97,90,187,85
"Vrána, Petr",F,03/29/1985,Sternberk,Czech Republic,16,1,0,1,2
"Vrbata, Radim",F,06/13/1981,Mlada Boleslav,Czech Republic,1057,284,339,623,294
"Vujtek, Vladimír",F,02/17/1972,Ostrava,Czech Republic,110,7,30,37,38
"Vukota, Mick",F,09/14/1966,"Saskatoon, Saskatchewan",Canada,573,17,29,46,2071
"Vyazmikin, Igor",F,01/08/1966,Moscow,Russia,4,1,0,1,0
"Výborný, David",F,01/22/1975,Jihlava,Czech Republic,543,113,204,317,228
"Vyshedkevich, Sergei",D,01/03/1975,Dedovsk,Russia,30,2,5,7,16
"Waddell, Don",D,08/19/1958,"Detroit, Michigan",United States,1,0,0,0,0
"Wagner, Austin",F,06/23/1997,"Calgary, Alberta",Canada,171,22,18,40,70
"Wagner, Chris",F,05/27/1991,"Wellesley, Massachusetts",United States,359,37,26,63,195
"Wagner, Steve",D,03/06/1984,"Grand Rapids, Minnesota",United States,46,4,8,12,26
"Wahlstrom, Oliver",F,06/13/2000,"Yarmouth, Maine",United States,126,25,20,45,99
"Waite, Frank",F,04/09/1905,"Fort Qu'Appelle, Saskatchewan",Canada,17,1,3,4,4
"Waite, Jim",G,04/15/1969,"Sherbrooke, Quebec",Canada,106,0,1,1,10
"Wakaluk, Darcy",G,03/14/1966,"Pincher Creek, Alberta",Canada,191,0,6,6,90
"Wakely, Ernie",G,11/27/1940,"Flin Flon, Manitoba",Canada,113,0,2,2,2
"Walcott, Daniel",D,02/19/1994,"Île Perrot, Quebec",Canada,1,0,0,0,5
"Walker, Gord",F,08/12/1965,"Castlegar, British Columbia",Canada,31,3,4,7,23
"Walker, Howard",D,08/05/1958,"Grande Prairie, Alberta",Canada,83,2,13,15,133
"Walker, Jack",F,11/29/1888,"Silver Mountain, Ontario",Canada,84,5,8,13,16
"Walker, Kurt",D,06/10/1954,"Weymouth, Massachusetts",United States,71,4,5,9,152
"Walker, Matt",D,04/07/1980,"Beaverlodge, Alberta",Canada,314,4,26,30,464
"Walker, Nathan",F,02/07/1994,"Cardiff, Wales",United Kingdom,55,11,6,17,16
"Walker, Russ",F,05/24/1953,"Red Deer, Alberta",Canada,17,1,0,1,41
"Walker, Scott",F,07/19/1973,"Cambridge, Ontario",Canada,829,151,246,397,1162
"Walker, Sean",D,11/13/1994,"Keswick, Ontario",Canada,162,13,41,54,56
"Wall, Bob",D,12/01/1942,"Richmond Hill, Ontario",Canada,322,30,55,85,155
"Wall, Michael",G,07/25/1985,"Telkwa, British Columbia",Canada,4,0,1,1,0
"Wallace, Tim",F,08/06/1984,"Anchorage, Alaska",United States,101,4,9,13,45
"Wallin, Jesse",D,03/10/1978,"Saskatoon, Saskatchewan",Canada,49,0,2,2,34
"Wallin, Niclas",D,02/20/1975,Boden,Sweden,614,21,58,79,460
"Wallin, Peter",F,04/30/1957,Stockholm,Sweden,52,3,14,17,14
"Wallin, Rickard",F,04/09/1980,Stockholm,Sweden,79,8,11,19,34
"Wallmark, Lucas",F,09/05/1995,Umeå,Sweden,187,23,36,59,64
"Walman, Jake",D,02/20/1996,"Toronto, Ontario",Canada,76,4,8,12,18
"Walser, Derrick",D,05/12/1978,"New Glasgow, Nova Scotia",Canada,91,8,21,29,56
"Walsh, James 'Flat'",G,03/23/1897,"Kingston, Ontario",Canada,111,0,0,0,0
"Walsh, Jim",D,10/26/1956,"Norfolk, Virginia",United States,4,0,1,1,4
"Walsh, Mike",F,04/03/1962,"New York, New York",United States,14,2,0,2,4
"Walsh, Reilly",D,04/21/1999,"Andover, New Hampshire",United States,1,0,1,1,0
"Walter, Ben",F,05/11/1984,"Beaconsfield, Quebec",Canada,24,1,0,1,6
"Walter, Ryan",F,04/23/1958,"New Westminster, British Columbia",Canada,1003,264,382,646,946
"Walton, Bobby",F,08/05/1912,"Ottawa, Ontario",Canada,4,0,0,0,0
"Walton, Mike",F,01/03/1945,"Kirkland Lake, Ontario",Canada,588,201,247,448,357
"Walz, Wes",F,05/15/1970,"Calgary, Alberta",Canada,607,109,151,260,343
"Wamsley, Rick",G,05/25/1959,"Simcoe, Ontario",Canada,407,0,9,9,52
"Wandell, Tom",F,01/29/1987,Södertälje,Sweden,229,20,23,43,52
"Wanvig, Kyle",F,01/29/1981,"Calgary, Alberta",Canada,75,6,9,15,94
"Wappel, Gord",D,07/26/1958,"Regina, Saskatchewan",Canada,20,1,1,2,10
"Ward, Aaron",D,01/17/1973,"Windsor, Ontario",Canada,839,44,107,151,736
"Ward, Cam",G,02/29/1984,"Saskatoon, Saskatchewan",Canada,701,1,12,13,48
"Ward, Dixon",F,09/23/1968,"Leduc, Alberta",Canada,537,95,129,224,431
"Ward, Don",D,10/19/1935,"Sarnia, Ontario",Canada,34,0,1,1,18
"Ward, Ed",F,11/10/1969,"Edmonton, Alberta",Canada,278,23,26,49,354
"Ward, Jason",F,01/16/1979,"Chapleau, Ontario",Canada,336,36,45,81,171
"Ward, Jimmy",F,09/01/1906,"Thunder Bay, Ontario",Canada,528,147,128,275,463
"Ward, Joe",F,02/11/1961,"Sarnia, Ontario",Canada,4,0,0,0,2
"Ward, Joel",F,12/02/1980,"Toronto, Ontario",Canada,726,133,171,304,261
"Ward, Lance",D,06/02/1978,"Lloydminster, Alberta",Canada,209,4,12,16,391
"Ward, Ron",F,09/12/1944,"Cornwall, Ontario",Canada,89,2,5,7,6
"Ware, Jeff",D,05/19/1977,"Toronto, Ontario",Canada,21,0,1,1,12
"Ware, Mike",F,03/22/1967,"York, Ontario",Canada,5,0,1,1,15
"Wares, Eddie",D,03/19/1915,"Calgary, Alberta",Canada,324,60,102,162,161
"Warner, Bob",D,12/13/1950,"Grimsby, Ontario",Canada,10,1,1,2,4
"Warner, Jim",F,03/26/1954,"St. Paul, Minnesota",United States,32,0,3,3,10
"Warrener, Rhett",D,01/27/1976,"Shaunavon, Saskatchewan",Canada,714,24,82,106,899
"Warriner, Todd",F,01/03/1974,"Blenheim, Ontario",Canada,453,65,89,154,249
"Warsofsky, David",D,05/30/1990,"Marshfield, Massachusetts",United States,55,2,9,11,8
"Warwick, Bill",F,11/17/1924,"Regina, Saskatchewan",Canada,14,3,3,6,16
"Warwick, Grant",F,10/11/1921,"Regina, Saskatchewan",Canada,395,147,142,289,220
"Washburn, Steve",F,04/10/1975,"Ottawa, Ontario",Canada,93,14,15,29,42
"Wasnie, Nick",F,01/01/1904,"Winnipeg, Manitoba",Canada,246,57,34,91,178
"Wathier, Francis",F,12/07/1984,"St. Isidore, Ontario",Canada,10,0,0,0,5
"Watkins, Matt",F,11/22/1986,"Regina, Saskatchewan",Canada,1,0,0,0,0
"Watson, Austin",F,01/13/1992,"Ann Arbor, Michigan",United States,407,49,54,103,489
"Watson, Bill",F,03/30/1964,"Pine Falls, Manitoba",Canada,115,23,36,59,12
"Watson, Bryan",D,11/14/1942,"Bancroft, Ontario",Canada,877,17,135,152,2214
"Watson, Dave",F,05/19/1958,"Kirkland Lake, Ontario",Canada,18,0,1,1,10
"Watson, Harry",F,05/06/1923,"Saskatoon, Saskatchewan",Canada,809,236,207,443,150
"Watson, Jim",D,06/28/1943,"Malartic, Quebec",Canada,221,4,19,23,345
"Watson, Jim",D,08/19/1952,"Smithers, British Columbia",Canada,613,38,148,186,492
"Watson, Joe",D,07/06/1943,"Smithers, British Columbia",Canada,836,38,178,216,449
"Watson, Phil",F,04/24/1914,"Montréal, Quebec",Canada,591,145,265,410,562
"Watt, Jim",G,05/11/1950,"Duluth, Minnesota",United States,1,0,0,0,0
"Watt, Mike",F,03/31/1976,"Seaforth, Ontario",Canada,157,15,26,41,41
"Watters, Tim",D,07/25/1959,"Kamloops, British Columbia",Canada,741,26,151,177,1289
"Watts, Brian",F,09/10/1947,"Hagersville, Ontario",Canada,4,0,0,0,0
"Weal, Jordan",F,04/15/1992,"North Vancouver, British Columbia",Canada,218,32,37,69,56
"Weatherby, Jasper",F,01/22/1998,"Portland, Oregon",United States,50,5,6,11,18
"Weaver, Mike",D,05/02/1978,"Bramalea, Ontario",Canada,633,8,89,97,227
"Webb, Steve",F,04/30/1975,"Peterborough, Ontario",Canada,321,5,13,18,532
"Weber, Mike",D,12/16/1987,"Pittsburgh, Pennsylvania",United States,351,9,44,53,437
"Weber, Shea",D,08/14/1985,"Sicamous, British Columbia",Canada,1038,224,365,589,714
"Weber, Yannick",D,09/23/1988,Morges,Switzerland,499,28,66,94,195
"Webster, Aubrey",F,09/25/1912,"Kenora, Ontario",Canada,4,0,0,0,0
"Webster, Don",F,07/03/1924,"Toronto, Ontario",Canada,27,7,6,13,28
"Webster, John",F,11/03/1920,"Toronto, Ontario",Canada,14,0,0,0,4
"Webster, Tom",F,10/04/1948,"Kirkland Lake, Ontario",Canada,102,33,42,75,61
"Wedgewood, Scott",G,08/14/1992,"Etobicoke, Ontario",Canada,77,0,0,0,2
"Wedin, Anton",F,03/01/1993,Sundsvall,Sweden,4,0,0,0,4
"Weegar, Mackenzie",D,01/07/1994,"Nepean, Ontario",Canada,306,27,94,121,259
"Weekes, Kevin",G,04/04/1975,"Toronto, Ontario",Canada,348,0,3,3,18
"Weeks, Steve",G,06/30/1958,"Scarborough, Ontario",Canada,291,0,7,7,21
"Weight, Doug",F,01/21/1971,"Warren, Michigan",United States,1238,278,755,1033,970
"Weiland, Cooney",F,11/05/1904,"Seaforth, Ontario",Canada,509,173,162,335,149
"Weiman, Tyler",G,06/05/1984,"Saskatoon, Saskatchewan",Canada,1,0,0,0,0
"Weinhandl, Mattias",F,06/01/1980,Ljungby,Sweden,182,19,37,56,70
"Weinrich, Eric",D,12/19/1966,"Roanoke, Virginia",United States,1157,70,318,388,825
"Weir, Stan",F,03/17/1952,"Ponoka, Alberta",Canada,642,139,207,346,183
"Weir, Wally",D,06/03/1954,"Verdun, Quebec",Canada,320,21,45,66,625
"Weise, Dale",F,08/05/1988,"Winnipeg, Manitoba",Canada,513,55,70,125,355
"Weiss, Stephen",F,04/03/1983,"Toronto, Ontario",Canada,732,156,267,423,341
"Welch, Noah",D,08/26/1982,"Brighton, Massachusetts",United States,75,4,5,9,58
"Welinski, Andrew",D,04/27/1993,"Duluth, Minnesota",United States,46,1,5,6,8
"Weller, Craig",F,03/17/1981,"Calgary, Alberta",Canada,95,4,10,14,127
"Wellington, Alex",D,08/04/1893,"Madoc, Ontario",Canada,1,0,0,0,0
"Wellman, Casey",F,10/18/1987,"Brentwood, California",United States,54,6,10,16,4
"Wells, Chris",F,11/12/1975,"Calgary, Alberta",Canada,195,9,20,29,193
"Wells, Jay",D,05/18/1959,"Paris, Ontario",Canada,1098,47,216,263,2359
"Wellwood, Eric",F,03/06/1990,"Windsor, Ontario",Canada,31,5,5,10,4
"Wellwood, Kyle",F,05/16/1983,"Windsor, Ontario",Canada,489,92,143,235,36
"Welsh, Jeremy",F,04/30/1988,"Bayfield, Ontario",Canada,27,1,1,2,12
"Wennberg, Alexander",F,09/24/1994,Nacka,Sweden,551,68,199,267,121
"Wensink, John",F,04/01/1953,"Cornwall, Ontario",Canada,403,70,68,138,840
"Wentworth, Cy",D,01/24/1905,"Grimsby, Ontario",Canada,575,39,68,107,359
"Werenka, Brad",D,02/12/1969,"Two Hills, Alberta",Canada,320,19,61,80,299
"Werenski, Zachary",D,07/19/1997,"Grosse Pointe, Michigan",United States,403,76,161,237,93
"Werner, Adam",G,05/02/1997,Mariestad,Sweden,2,0,0,0,0
"Wesenberg, Brian",F,05/09/1977,"Peterborough, Ontario",Canada,1,0,0,0,5
"Wesley, Blake",D,07/10/1959,"Red Deer, Alberta",Canada,298,18,46,64,486
"Wesley, Glen",D,10/02/1968,"Red Deer, Alberta",Canada,1457,128,409,537,1045
"Westcott, Duvie",D,10/30/1977,"Winnipeg, Manitoba",Canada,201,11,45,56,299
"Westfall, Ed",F,09/19/1940,"Belleville, Ontario",Canada,1226,231,394,625,544
"Westgarth, Kevin",F,02/07/1984,"Amherstburg, Ontario",Canada,169,7,9,16,266
"Westlund, Tommy",F,12/29/1974,Fors,Sweden,203,9,13,22,48
"Westrum, Erik",F,07/26/1979,"Minneapolis, Minnesota",United States,27,1,2,3,22
"Wetzel, Carl",G,12/12/1938,"Detroit, Michigan",United States,7,0,0,0,0
"Wey, Patrick",D,03/21/1991,"Pittsburgh, Pennsylvania",United States,9,0,3,3,5
"Wharram, Kenny",F,07/02/1933,"North Bay, Ontario",Canada,766,252,281,533,220
"Wharton, Len",D,12/13/1927,"Winnipeg, Manitoba",Canada,1,0,0,0,0
"Wheeldon, Simon",F,08/30/1966,"Vancouver, British Columbia",Canada,15,0,2,2,10
"Wheeler, Blake",F,08/31/1986,"Robbinsdale, Minnesota",United States,1046,296,571,867,695
"Wheldon, Donald",D,12/28/1954,"Falmouth, Massachusetts",United States,2,0,0,0,0
"Whelton, Bill",D,08/28/1959,"Everett, Massachusetts",United States,2,0,0,0,0
"Whistle, Rob",D,04/04/1961,"Thunder Bay, Ontario",Canada,51,7,5,12,16
"White, Bill",D,08/26/1939,"Toronto, Ontario",Canada,604,50,215,265,495
"White, Brian",D,02/07/1976,"Winchester, Massachusetts",United States,2,0,0,0,0
"White, Colin",F,01/30/1997,"Hanover, Massachusetts",United States,224,36,62,98,91
"White, Colin",D,12/12/1977,"New Glasgow, Nova Scotia",Canada,797,21,108,129,869
"White, Colton",D,05/03/1997,"London, Ontario",Canada,38,0,4,4,14
"White, Ian",D,06/04/1984,"Steinbach, Manitoba",Canada,503,45,134,179,254
"White, Moe",F,07/28/1919,"Verdun, Quebec",Canada,4,0,1,1,2
"White, Peter",F,03/15/1969,"Montréal, Quebec",Canada,220,23,37,60,36
"White, Ryan",F,03/17/1988,"Brandon, Manitoba",Canada,313,31,30,61,447
"White, Sherman",F,05/12/1923,"Cape Tormentine, New Brunswick",Canada,4,0,2,2,0
"White, Todd",F,05/21/1975,"Kanata, Ontario",Canada,653,141,240,381,228
"White, Tony",F,06/16/1954,"Grand Falls, Newfoundland and Labrador",Canada,164,37,28,65,104
"White, Wilfred 'Tex'",F,06/26/1900,"Hillsburgh, Ontario",Canada,204,33,14,47,145
"Whitecloud, Zach",D,11/28/1996,"Brandon, Manitoba",Canada,127,10,22,32,48
"Whitelaw, Bob",D,10/05/1916,"Motherwell, Scotland",United Kingdom,32,0,1,1,2
"Whitfield, Trent",F,06/17/1977,"Estevan, Saskatchewan",Canada,194,11,18,29,104
"Whitlock, Bob",F,07/16/1949,"Charlottetown, Prince Edward Island",Canada,1,0,0,0,0
"Whitmore, Derek",F,12/17/1984,"Rochester, New York",United States,2,0,0,0,0
"Whitmore, Kay",G,04/10/1967,"Sudbury, Ontario",Canada,155,0,9,9,39
"Whitney, Joe",F,02/06/1988,"Reading, Massachusetts",United States,5,1,0,1,0
"Whitney, Ray",F,05/08/1972,"Fort Saskatchewan, Alberta",Canada,1330,385,679,1064,465
"Whitney, Ryan",D,02/19/1983,"Scituate, Massachusetts",United States,481,50,209,259,383
"Whyte, Sean",F,05/04/1970,"Sudbury, Ontario",Canada,21,0,2,2,12
"Wick, Roman",F,12/30/1985,Zuzwil,Switzerland,7,0,0,0,0
"Wickenheiser, Doug",F,03/30/1961,"Regina, Saskatchewan",Canada,556,111,165,276,286
"Wideman, Chris",D,01/07/1990,"St. Louis, Missouri",United States,245,20,52,72,171
"Wideman, Dennis",D,03/20/1983,"Kitchener, Ontario",Canada,815,99,288,387,503
"Widing, Juha",F,07/04/1947,Oulu,Finland,574,144,226,370,208
"Widmer, Jason",D,08/01/1973,"Calgary, Alberta",Canada,7,0,1,1,7
"Wiebe, Art",D,09/28/1912,"Rosthern, Saskatchewan",Canada,412,14,26,40,201
"Wiemer, Jason",F,04/14/1976,"Kimberley, British Columbia",Canada,726,90,112,202,1420
"Wiemer, Jim",D,01/09/1961,"Sudbury, Ontario",Canada,325,29,72,101,378
"Wiercioch, Patrick",D,09/12/1990,"Burnaby, British Columbia",Canada,268,16,58,74,138
"Wilcox, Adam",G,11/26/1992,"South St. Paul, Minnesota",United States,1,0,0,0,0
"Wilcox, Archie",D,05/09/1903,"Montréal, Quebec",Canada,208,8,14,22,160
"Wilcox, Barry",F,04/23/1948,"New Westminster, British Columbia",Canada,33,3,2,5,15
"Wilder, Arch",F,04/30/1917,"Melville, Saskatchewan",Canada,18,0,2,2,2
"Wiley, Jim",F,04/28/1950,"Sault Ste. Marie, Ontario",Canada,63,4,10,14,8
"Wilkie, Bob",D,02/11/1969,"Calgary, Alberta",Canada,18,2,5,7,10
"Wilkie, David",D,05/30/1974,"Ellensburg, Washington",United States,167,10,26,36,165
"Wilkins, Barry",D,02/28/1947,"Toronto, Ontario",Canada,418,27,125,152,665
"Wilkinson, Derek",G,07/29/1974,"LaSalle, Quebec",Canada,22,0,0,0,2
"Wilkinson, John",D,07/09/1911,"Ottawa, Ontario",Canada,9,0,0,0,6
"Wilkinson, Neil",D,08/15/1967,"Selkirk, Manitoba",Canada,460,16,67,83,813
"Wilks, Brian",F,02/27/1966,"Toronto, Ontario",Canada,48,4,8,12,27
"Will, Roman",G,05/22/1992,Plzen,Czech Republic,1,0,0,0,0
"Willard, Rod",F,05/01/1960,"New Liskeard, Ontario",Canada,1,0,0,0,0
"Williams, Burr",D,08/30/1909,"Okemah, Oklahoma",United States,22,0,1,1,28
"Williams, Butch",F,09/11/1952,"Duluth, Minnesota",United States,108,14,35,49,131
"Williams, Darryl",F,02/29/1968,"Labrador City, Newfoundland and Labrador",Canada,2,0,0,0,10
"Williams, David",D,08/25/1967,"Plainfield, New Jersey",United States,173,11,53,64,157
"Williams, Fred",F,07/01/1956,"Saskatoon, Saskatchewan",Canada,44,2,5,7,10
"Williams, Gord",F,04/10/1960,"Saskatoon, Saskatchewan",Canada,2,0,0,0,2
"Williams, Jason",F,08/11/1980,"London, Ontario",Canada,455,94,133,227,157
"Williams, Jeremy",F,01/26/1984,"Regina, Saskatchewan",Canada,32,9,2,11,6
"Williams, Justin",F,10/04/1981,"Cobourg, Ontario",Canada,1264,320,477,797,766
"Williams, Sean",F,01/28/1968,"Oshawa, Ontario",Canada,2,0,0,0,4
"Williams, Tiger",F,02/03/1954,"Weyburn, Saskatchewan",Canada,962,241,272,513,3971
"Williams, Tom",F,04/17/1940,"Duluth, Minnesota",United States,664,161,269,430,173
"Williams, Tom",F,02/07/1951,"Windsor, Ontario",Canada,397,115,138,253,73
"Willis, Jordan",G,02/28/1975,"Kincardine, Ontario",Canada,1,0,0,0,0
"Willis, Shane",F,06/13/1977,"Edmonton, Alberta",Canada,174,31,43,74,77
"Willman, Maxwell",F,02/13/1995,"Barnstable, Massachusetts",United States,41,4,2,6,16
"Willsie, Brian",F,03/16/1978,"London, Ontario",Canada,381,52,57,109,217
"Willson, Don",F,01/01/1914,"Chatham, Ontario",Canada,22,2,7,9,0
"Wilm, Clarke",F,10/24/1976,"Central Butte, Saskatchewan",Canada,455,37,60,97,336
"Wilson, Behn",D,12/19/1958,"Toronto, Ontario",Canada,601,98,261,359,1480
"Wilson, Bert",F,10/17/1949,"Orangeville, Ontario",Canada,478,37,44,81,646
"Wilson, Bob",D,02/18/1934,"Sudbury, Ontario",Canada,1,0,0,0,0
"Wilson, Carey",F,05/19/1962,"Winnipeg, Manitoba",Canada,552,169,258,427,314
"Wilson, Clay",D,04/05/1983,"Sturgeon Lake, Minnesota",United States,36,4,4,8,12
"Wilson, Colin",F,10/20/1989,"Greenwich, Connecticut",United States,632,113,173,286,138
"Wilson, Cully",F,06/05/1892,"Winnipeg, Manitoba",Canada,130,59,28,87,245
"Wilson, Doug",D,07/05/1957,"Ottawa, Ontario",Canada,1024,237,590,827,830
"Wilson, Dunc",G,03/22/1948,"Toronto, Ontario",Canada,287,0,4,4,83
"Wilson, Garrett",F,03/16/1991,"Elmvale, Ontario",Canada,84,2,6,8,42
"Wilson, Hub",F,05/13/1909,"Ottawa, Ontario",Canada,2,0,0,0,0
"Wilson, Jerry",F,04/10/1937,"Edmonton, Alberta",Canada,3,0,0,0,2
"Wilson, Johnny",F,06/14/1929,"Kincardine, Ontario",Canada,688,161,171,332,188
"Wilson, Kyle",F,12/15/1984,"Oakville, Ontario",Canada,39,4,9,13,12
"Wilson, Landon",F,03/13/1975,"St. Louis, Missouri",United States,375,53,66,119,352
"Wilson, Larry",F,10/23/1930,"Kincardine, Ontario",Canada,152,21,48,69,73
"Wilson, Lefty",G,10/15/1919,"Toronto, Ontario",Canada,3,0,0,0,0
"Wilson, Mike",D,02/26/1975,"Brampton, Ontario",Canada,336,16,41,57,264
"Wilson, Mitch",F,02/15/1962,"Kelowna, British Columbia",Canada,26,2,3,5,104
"Wilson, Murray",F,11/07/1951,"Toronto, Ontario",Canada,386,94,95,189,162
"Wilson, Rick",D,08/10/1950,"Prince Albert, Saskatchewan",Canada,239,6,26,32,165
"Wilson, Rik",D,06/17/1962,"Long Beach, California",United States,251,25,65,90,220
"Wilson, Roger",D,09/18/1946,"Sudbury, Ontario",Canada,7,0,2,2,6
"Wilson, Ron",F,05/13/1956,"Toronto, Ontario",Canada,831,110,216,326,413
"Wilson, Ron",D,05/28/1955,"Windsor, Ontario",Canada,177,26,67,93,68
"Wilson, Ryan",D,02/03/1987,"Windsor, Ontario",Canada,230,7,60,67,157
"Wilson, Scott",F,04/24/1992,"Oakville, Ontario",Canada,193,20,31,51,58
"Wilson, Tom",F,03/29/1994,"Toronto, Ontario",Canada,647,115,158,273,1221
"Wilson, Wally",F,05/25/1921,"Berwick, Nova Scotia",Canada,53,11,8,19,18
"Winchester, Brad",F,03/01/1981,"Madison, Wisconsin",United States,390,37,31,68,552
"Winchester, Jesse",F,10/04/1983,"Long Sault, Ontario",Canada,285,20,50,70,159
"Wing, Murray",D,10/14/1950,"Thunder Bay, Ontario",Canada,1,0,1,1,0
"Wingels, Tommy",F,04/12/1988,"Evanston, Illinois",United States,448,62,81,143,254
"Winkler, Hal",G,03/20/1892,"Gretna, Manitoba",Canada,75,0,0,0,0
"Winnes, Chris",F,02/12/1968,"Ridgefield, Connecticut",United States,33,1,6,7,6
"Winnik, Daniel",F,03/06/1985,"Toronto, Ontario",Canada,798,82,169,251,367
"Wirtanen, Petteri",F,05/28/1986,Hyvinkää,Finland,3,1,0,1,2
"Wiseman, Brian",F,07/13/1971,"Chatham, Ontario",Canada,3,0,0,0,0
"Wiseman, Chad",F,03/25/1981,"Burlington, Ontario",Canada,9,1,1,2,8
"Wiseman, Eddie",F,12/28/1912,"Newcastle, New Brunswick",Canada,456,114,165,279,141
"Wishart, Ty",D,05/19/1988,"Belleville, Ontario",Canada,26,1,5,6,10
"Wisniewski, James",D,02/21/1984,"Canton, Michigan",United States,552,53,221,274,459
"Wiste, Jim",F,02/18/1946,"Moose Jaw, Saskatchewan",Canada,52,1,10,11,8
"Witehall, Johan",F,01/07/1972,Göteborg,Sweden,54,2,5,7,16
"Witherspoon, Jim",D,10/03/1951,"Toronto, Ontario",Canada,2,0,0,0,2
"Witiuk, Steve",F,01/08/1929,"Winnipeg, Manitoba",Canada,33,3,8,11,14
"Witkowski, Luke",D,04/14/1990,"Holland, Michigan",United States,132,2,11,13,162
"Witt, Brendan",D,02/20/1975,"Humboldt, Saskatchewan",Canada,890,25,96,121,1424
"Woit, Benny",D,01/07/1928,"Thunder Bay, Ontario",Canada,334,7,26,33,170
"Wojciechowski, Steven",F,12/25/1922,"Thunder Bay, Ontario",Canada,54,19,20,39,17
"Wolanin, Christian",D,03/17/1995,"Québec City, Quebec",Canada,70,6,14,20,16
"Wolanin, Craig",D,07/27/1967,"Grosse Pointe, Michigan",United States,695,40,133,173,894
"Wolf, Bennett",D,10/23/1959,"Kitchener, Ontario",Canada,30,0,1,1,133
"Wolf, David",F,09/15/1989,Düsseldorf,Germany,3,0,0,0,2
"Wolfe, Bernie",G,12/18/1951,"Montréal, Quebec",Canada,119,0,1,1,2
"Woll, Joseph",G,07/12/1998,"Dardenne Prairie, Missouri",United States,4,0,0,0,2
"Wolski, Wojtek",F,02/24/1986,Zabrze,Poland,451,99,168,267,113
"Wong, Mike",F,01/14/1955,"Minneapolis, Minnesota",United States,22,1,1,2,12
"Wood, Dody",F,03/18/1972,"Chetwynd, British Columbia",Canada,106,8,10,18,471
"Wood, Miles",F,09/13/1995,"Buffalo, New York",United States,326,65,56,121,351
"Wood, Randy",F,10/12/1963,"Princeton, New Jersey",United States,741,175,159,334,603
"Wood, Robert",D,07/09/1930,"Lethbridge, Alberta",Canada,1,0,0,0,0
"Woodley, Dan",F,12/29/1967,"Oklahoma City, Oklahoma",United States,5,2,0,2,17
"Woods, Alec",G,01/15/1911,"Falkirk, Scotland",United Kingdom,1,0,0,0,0
"Woods, Brendan",F,06/11/1992,"Humboldt, Saskatchewan",Canada,7,0,0,0,7
"Woods, Paul",F,04/12/1955,"Hespeler, Ontario",Canada,501,72,124,196,276
"Woolley, Jason",D,07/27/1969,"Toronto, Ontario",Canada,718,68,246,314,430
"Worrell, Peter",F,08/18/1977,"Pierrefonds, Quebec",Canada,391,19,27,46,1554
"Worsley, Gump",G,05/14/1929,"Montréal, Quebec",Canada,860,0,3,3,137
"Worters, Roy",G,10/19/1900,"Toronto, Ontario",Canada,484,0,0,0,0
"Worthy, Chris",G,10/23/1947,"Bristol, England",United Kingdom,26,0,0,0,6
"Wortman, Kevin",D,02/22/1969,"Saugus, Massachusetts",United States,5,0,0,0,2
"Wotherspoon, Tyler",D,03/12/1993,"Burnaby, British Columbia",Canada,30,0,5,5,4
"Wotton, Mark",D,11/16/1973,"Foxwarren, Manitoba",Canada,43,3,6,9,25
"Woytowich, Bob",D,08/18/1941,"Winnipeg, Manitoba",Canada,504,32,126,158,354
"Woywitka, Jeff",D,09/01/1983,"Vermilion, Alberta",Canada,278,9,46,55,149
"Wozniewski, Andy",D,05/25/1980,"Buffalo Grove, Illinois",United States,79,2,10,12,81
"Wregget, Ken",G,03/25/1964,"Brandon, Manitoba",Canada,575,0,24,24,182
"Wren, Bob",F,09/16/1974,"Preston, Ontario",Canada,5,0,0,0,0
"Wright, James",F,03/24/1990,"Saskatoon, Saskatchewan",Canada,146,4,8,12,64
"Wright, Jamie",F,05/13/1976,"Kitchener, Ontario",Canada,124,12,20,32,54
"Wright, John",F,11/09/1948,"Toronto, Ontario",Canada,127,16,36,52,67
"Wright, Keith",F,04/13/1944,"Aurora, Ontario",Canada,1,0,0,0,0
"Wright, Larry",F,10/08/1951,"Regina, Saskatchewan",Canada,106,4,8,12,19
"Wright, Tyler",F,04/06/1973,"Kamsack, Saskatchewan",Canada,613,79,70,149,854
"Wycherley, Ralph",F,02/26/1920,"Saskatoon, Saskatchewan",Canada,28,4,7,11,6
"Wylie, Duane",F,11/10/1950,"Spokane, Washington",United States,14,3,3,6,2
"Wylie, William",F,07/15/1928,"Galt, Ontario",Canada,1,0,0,0,0
"Wyman, James",F,02/27/1986,"Edina, Minnesota",United States,44,2,9,11,8
"Wyrozub, Randy",F,04/08/1950,"Lacombe, Alberta",Canada,100,8,10,18,10
"Yablonski, Jeremy",F,03/21/1980,"Meadow Lake, Saskatchewan",Canada,1,0,0,0,5
"Yachmenev, Vitali",F,01/08/1975,Chelyabinsk,Russia,487,83,133,216,88
"Yackel, Ken",F,03/05/1932,"St. Paul, Minnesota",United States,6,0,0,0,2
"Yake, Terry",F,10/22/1968,"New Westminster, British Columbia",Canada,403,77,120,197,220
"Yakimov, Bogdan",F,10/04/1994,Nizhnekamsk,Russia,1,0,0,0,0
"Yakovlev, Yegor",D,09/17/1991,Magnitogorsk,Russia,25,2,5,7,6
"Yakubov, Mikhail",F,02/16/1982,Barnaul,Russia,53,2,10,12,20
"Yakupov, Nail",F,10/06/1993,Nizhnekamsk,Russia,350,62,74,136,142
"Yakushin, Dmitri",D,01/21/1978,Kharkiv,Ukraine,2,0,0,0,2
"Yamamoto, Kailer",F,09/29/1998,"Spokane, Washington",United States,186,40,53,93,82
"Yandle, Keith",D,09/09/1986,"Boston, Massachusetts",United States,1109,103,516,619,616
"Yaremchuk, Gary",F,08/15/1961,"Edmonton, Alberta",Canada,34,1,4,5,28
"Yaremchuk, Ken",F,01/01/1964,"Edmonton, Alberta",Canada,235,36,56,92,106
"Yashin, Alexei",F,11/05/1973,Yekaterinburg,Russia,850,337,444,781,401
"Yates, Ross",F,06/18/1959,"Montréal, Quebec",Canada,7,1,1,2,4
"Yawney, Trent",D,09/29/1965,"Hudson Bay, Saskatchewan",Canada,593,27,102,129,783
"Yeats, Matt",G,04/06/1979,"Montréal, Quebec",Canada,5,0,0,0,2
"Yegorov, Alexei",F,05/21/1975,Saint Petersburg,Russia,11,3,3,6,2
"Yelesin, Alexander",D,02/07/1996,Yaroslavl,Russia,4,0,0,0,0
"Yelle, Stephane",F,05/09/1974,"Ottawa, Ontario",Canada,991,96,169,265,490
"Yeremeyev, Vitali",G,09/23/1975,Ust-Kamenogorsk,Kazakhstan,4,0,0,0,0
"Yip, Brandon",F,04/25/1985,"Vancouver, British Columbia",Canada,174,29,27,56,130
"Ylönen, Jesse",F,10/03/1999,"Scottsdale, Arizona",United States,15,2,3,5,2
"Ylönen, Juha",F,02/13/1972,Helsinki,Finland,341,26,76,102,90
"Yonkman, Nolan",D,04/01/1981,"Punnichy, Saskatchewan",Canada,76,1,9,10,140
"York, Allen",G,06/17/1989,"Wetaskiwin, Alberta",Canada,11,0,0,0,0
"York, Cam",D,01/05/2001,"Anaheim Hills, California",United States,33,3,7,10,6
"York, Harry",F,04/16/1974,"Ponoka, Alberta",Canada,244,29,46,75,99
"York, Jason",D,05/20/1970,"Nepean, Ontario",Canada,757,42,187,229,621
"York, Mike",F,01/03/1978,"Waterford Township, Michigan",United States,579,127,195,322,135
"Young, B.J.",F,07/23/1977,"Anchorage, Alaska",United States,1,0,0,0,0
"Young, Brian",D,10/02/1958,"Jasper, Alberta",Canada,8,0,2,2,6
"Young, Bryan",D,08/06/1986,"Ennismore, Ontario",Canada,17,0,0,0,10
"Young, C.J.",F,01/01/1968,"Waban, Massachusetts",United States,43,7,7,14,32
"Young, Doug",D,10/01/1908,"Medicine Hat, Alberta",Canada,388,35,45,80,305
"Young, Howie",D,08/02/1937,"Toronto, Ontario",Canada,336,12,62,74,851
"Young, Scott",F,10/01/1967,"Clinton, Massachusetts",United States,1181,342,415,757,448
"Young, Tim",F,02/22/1955,"Scarborough, Ontario",Canada,629,195,341,536,438
"Young, Warren",F,01/11/1956,"Toronto, Ontario",Canada,236,72,77,149,472
"Young, Wendell",G,08/01/1963,"Halifax, Nova Scotia",Canada,187,0,10,10,20
"Younghans, Tom",F,01/22/1953,"St. Paul, Minnesota",United States,429,44,41,85,373
"Ysebaert, Paul",F,05/15/1966,"Sarnia, Ontario",Canada,532,149,187,336,217
"Yurtaikin, Danil",F,07/01/1997,Belovo,Russia,4,0,0,0,0
"Yushkevich, Dmitri",D,11/19/1971,Cherepovets,Russia,786,43,182,225,659
"Yzerman, Steve",F,05/09/1965,"Cranbrook, British Columbia",Canada,1514,692,1063,1755,924
"Zaba, Matt",G,07/14/1983,"Yorkton, Saskatchewan",Canada,1,0,0,0,0
"Zábranský, Libor",D,11/25/1973,Brno,Czech Republic,40,1,6,7,50
"Zacha, Pavel",F,04/06/1997,Brno,Czech Republic,386,69,110,179,110
"Zadina, Filip",F,11/27/1999,Pardubice,Czech Republic,160,25,36,61,12
"Zadorov, Nikita",D,04/16/1995,Moscow,Russia,485,27,78,105,496
"Zagidulin, Artyom",G,08/08/1995,Magnitogorsk,Russia,1,0,0,0,0
"Zaharko, Miles",D,04/30/1957,"Mannville, Alberta",Canada,129,5,32,37,84
"Zaine, Rod",F,05/18/1946,"Ottawa, Ontario",Canada,61,10,6,16,25
"Zaitsev, Nikita",D,10/29/1991,Moscow,Russia,398,19,84,103,163
"Zajac, Travis",F,05/13/1985,"Winnipeg, Manitoba",Canada,1037,203,349,552,344
"Zalapski, Zarley",D,04/22/1968,"Edmonton, Alberta",Canada,637,99,285,384,684
"Zalesak, Miroslav",F,07/31/1980,Skalica,Slovakia,12,1,2,3,0
"Zalewski, Michael",F,08/18/1992,"New Hartford, New York",United States,6,0,2,2,2
"Zalewski, Steven",F,08/20/1986,"Utica, New York",United States,10,0,0,0,0
"Zamula, Yegor",D,03/30/2000,Chelyabinsk,Russia,12,0,0,0,4
"Zamuner, Rob",F,09/17/1969,"Oakville, Ontario",Canada,798,139,172,311,467
"Zanier, Mike",G,08/22/1962,"Trail, British Columbia",Canada,3,0,0,0,0
"Zanon, Greg",D,06/05/1980,"Burnaby, British Columbia",Canada,493,12,50,62,230
"Zanussi, Joe",D,09/25/1947,"Rossland, British Columbia",Canada,87,1,13,14,46
"Zanussi, Ron",F,08/31/1956,"Toronto, Ontario",Canada,299,52,83,135,373
"Zatkoff, Jeff",G,06/09/1987,"Detroit, Michigan",United States,48,0,1,1,0
"Zavisha, Bradley",F,01/04/1972,"Hines Creek, Alberta",Canada,2,0,0,0,0
"Zboril, Jakub",D,02/21/1997,Brno,Czech Republic,54,0,12,12,22
"Zednik, Richard",F,01/06/1976,Banska Bystrica,Slovakia,745,200,179,379,563
"Zegras, Trevor",F,03/20/2001,"Bedford, New York",United States,99,26,48,74,62
"Zehr, Jeff",F,12/10/1978,"Woodstock, Ontario",Canada,4,0,0,0,2
"Zeidel, Larry",D,06/01/1928,"Montréal, Quebec",Canada,158,3,16,19,198
"Zeiler, John",F,11/21/1982,"Jefferson Hills, Pennsylvania",United States,90,1,4,5,87
"Zelepukin, Valeri",F,09/17/1968,Voskresensk,Russia,595,117,177,294,527
"Zemlak, Richard",F,03/03/1963,"Wynyard, Saskatchewan",Canada,133,2,12,14,587
"Zeniuk, Ed",D,03/08/1933,"Landis, Saskatchewan",Canada,2,0,0,0,0
"Zent, Jason",F,04/15/1971,"Buffalo, New York",United States,27,3,3,6,13
"Zepp, Rob",G,09/07/1981,"Newmarket, Ontario",Canada,10,0,0,0,0
"Zetterberg, Henrik",F,10/09/1980,Njurunda,Sweden,1082,337,623,960,401
"Zetterlund, Fabian",F,08/25/1999,Karlstad,Sweden,14,3,5,8,0
"Zetterstrom, Lars",D,11/06/1953,Stockholm,Sweden,14,0,1,1,2
"Zettler, Rob",D,03/08/1968,"Sept-Îles, Quebec",Canada,569,5,65,70,920
"Zezel, Peter",F,04/22/1965,"Toronto, Ontario",Canada,873,219,388,607,435
"Zhamnov, Alexei",F,10/01/1970,Moscow,Russia,807,249,470,719,668
"Zharkov, Vladimir",F,01/10/1988,Elektrostal,Russia,82,2,12,14,10
"Zherdev, Nikolai",F,11/05/1984,Kiev,Ukraine,421,115,146,261,225
"Zhitnik, Alexei",D,10/10/1972,Kiev,Ukraine,1085,96,375,471,1268
"Zholtok, Sergei",F,12/02/1972,Riga,Latvia,588,111,147,258,166
"Zibanejad, Mika",F,04/18/1993,Stockholm,Sweden,685,229,286,515,185
"Židlický, Marek",D,02/03/1977,Most,Czech Republic,836,89,328,417,680
"Ziegler, Thomas",F,06/09/1978,Zürich,Switzerland,5,0,0,0,0
"Zigomanis, Michael",F,01/17/1981,"Toronto, Ontario",Canada,197,21,19,40,89
"Zinger, Dwayne",D,07/05/1976,"Coronation, Alberta",Canada,7,0,1,1,9
"Zinovjev, Sergei",F,03/04/1980,Novokuznetsk,Russia,10,0,1,1,2
"Zizka, Tomas",D,10/10/1979,Sternberk,Czech Republic,25,2,6,8,16
"Zmolek, Doug",D,11/03/1970,"Rochester, Minnesota",United States,467,11,53,64,905
"Zoboroski, Marty",D,11/12/1916,"Moose Jaw, Saskatchewan",Canada,1,0,0,0,2
"Zohorna, Radim",F,04/29/1996,Havlickuv Brod,Czech Republic,25,4,6,10,8
"Zolnierczyk, Harrison",F,09/01/1987,"Toronto, Ontario",Canada,84,7,6,13,93
"Zombo, Rick",D,05/08/1963,"Des Plaines, Illinois",United States,652,24,130,154,728
"Zub, Artyom",D,10/03/1995,Khabarovsk,Russia,128,9,27,36,86
"Zubarev, Andrei",D,03/03/1987,Ufa,Russia,4,0,1,1,4
"Zubov, Ilya",F,02/14/1987,Chelyabinsk,Russia,11,0,2,2,0
"Zubov, Sergei",D,07/22/1970,Moscow,Russia,1068,152,619,771,337
"Zubrus, Dainius",F,06/16/1978,Elektrenai,Lithuania,1293,228,363,591,791
"Zuccarello, Mats",F,09/01/1987,Oslo,Norway,688,164,342,506,265
"Zucker, Jason",F,01/16/1992,"Newport Beach, California",United States,550,155,135,290,209
"Zuke, Mike",F,04/16/1954,"Sault Ste. Marie, Ontario",Canada,455,86,196,282,220
"Zunich, Rudy",D,11/24/1910,"Calumet, Michigan",United States,2,0,0,0,2
"Zykov, Valentin",F,05/15/1995,Saint Petersburg,Russia,55,7,10,17,10
"Zyuzin, Andrei",D,01/21/1978,Ufa,Russia,496,38,82,120,446